der Sondergast - special guest
jmd. vorwarnen - to warn sb. in advance
wach - awake
jmd. wecken - to wake sb. up
gezwungenermaßen - of necessity
aufstehen - to get up
etw. mithören - to listen to sth.
groggy (ugs.) - exhausted (colloq.)
etw. verändern - to change sth.
ins neue Jahr rutschen (ugs.) - to start into the new year
die Feier - party
entspannt - relaxed
gemütlich - comfortable
entfliehen - to escape
die Böllerei (ugs.) - letting of fireworks
etw. erwähnen - to mention sth.
mit etw. anfangen - to start with sth.
etw. prophezeihen - to predict sth.
etw. annehmen - to accept sth.
etw. schätzen - to guess sth.
das Kontaktformular - contact form
etw. vortragen - to present sth.
persönlich - personally
die Übung - exercise
zwischendurch - in between
witzig - funny
die Verrenkung - contortion
der Zusammenhang - context
jmd. zu etw. aufrufen - to call upon sb. to do sth.
schicken - to send
die Freude - joy
die Geschichte - story
schicken - send
der Kommentar - comment
das Mitglied - member
kurz - short
die Privilegierung - the privilege
das Thema - topic
über etw. reden - to speak about sth.
jmd. zu etw. ermutigen - to motivate sb. to do sth.
stattfinden - to take place
der Januar - January
die Kneipe - the bar
jd. treffen - to meet sb.
etw. finden - to think of sth.
überrascht sein - to be surprised
etw. dazulernen - to learn sth.
passieren - to happen
etw. klar werden - to work sth. out
begreifen - to understand
messen - to measure
etw. verwenden - to use sth.
etw. verstecken - to hide sth.
bis jetzt - until now
der Gedanke - the thought
erzählen - to tell
deutlich - clearly
tragen - to carry
etw. beschreiben - to describe sth.
etw. herausstellen - to emphasize sth.
das Gespräch - conversation
unerreichbar - unreachable
der Begriff - term
benutzen - to use
kaputt - broken
bankrott - bankrupt
der Sinn - the sense
bei jdm. gehen die Alarmglocken an (uns.) - sb. sees the warning signs
der Sozialist - socialist
philosophieren - to philosophize
im Allgemeinen - in general
eigentlich - actually
anrufen - to call
quatschen (ugs.) - to chat (colloq.)
zu etw. kommen - to get around to sth.
jd. etw. widmen - to dedicate sth. to sb.
generell - generally
sich vorbereiten - to get ready
krampfhaft - desperately
funktionieren - to work 
reiben - to rub
wiederholen - to repeat
etw. auswendig lernen - to memorize sth.
etw. vorbereiten - to prepare sth.
ausgeschlossen - excluded
die Regel - rule
eingeschlossen - included
sich begrenzen - to limit oneself
verstehen - to understand
diskutieren - to debate
etw. abbrechen - to stop sth. 
die Redezeit - time for speaking
der Anlass - occasion
knackig - crispy
plötzlich - suddenly
schwierig - difficult
die Lösung - solution
die Lösung - the answer
abwickeln - to deal with sth.
recht haben - to be right
gleichzeitig - at the same time
etw. beibehalten - to maintain sth.
imstande sein - to be able
steuern - to control
der Einstieg - the start
das Grundproblem - the basic problem
der Hintergrund - the background
sich nennen - to call oneself
etw. anstreben - to strive for sth.
etw. ablehnen - to refuse sth.
die Diktatur - dictatorship
der Zwang - compulsion
identifizieren - to identify
die Vorstellung - idea
der Gegensatz - opposite
die Wirklichkeit - reality
die soziale Marktwirtschaft - social market economy
die Regierungsform - the form of government
Skandinavien - Scandinavia
etw. loben - to praise sth.
Geld verdienen - to make money
das Land - country
überzeugen - to convince
anmerken - to note
revidieren - to reverse
erleben - to experience
etw. umbauen - to convert sth.
immer noch - still
einmal - one time
etw. nachschauen - to look sth. up
tatsächlich - actually
jdn. bestätigen - to confirm sb.
etw. aufbauen - to build sth. up
im Klaren sein - be aware of
hilfreich - helpful
im Scherz - as a joke
zu viel - too much
gebraucht - used
etw. kaufen - to buy sth.
aggressiv - aggressive
sich erlauben - to take the liberty
etw. kritisieren - to criticize sth.
der Wohlstand - prosperity
definieren - to define
sich etw. ausdenken - to think up sth.
die Armut - poverty
führen - to lead
der Kampf - fight
der Gewinner - winner
der Verlierer - loser
mit Sicherheit - most certainly
profitieren - to benefit
das Grundeinkommen - the basic income
sich etw. leisten - to afford sth.
die Aussage - statement
grundlegend - fundamental
derzeitig - currently
etw. beibehalten - to stick with sth.
justieren - to adjust
etw. in den Griff bekommen - to get on top of sth.
wahrscheinlich - probably
schade - what a pity
egoistisch - selfish
überlegen - to think about
nachdenken - to think about
konsumieren - to consume
manchmal - sometimes
das Leben - life
selbst ernannt - self-declared
die Wahrheit - truth
entdecken - to discover
vernichten - to Destroy
etw. an sich ziehen - to attract sb./sth.
die Wahrheit - the truth
der Tod - death
auf der Suche nach etw. sein - to be looking for sth.
gleichbedeutend - synonymous
vermuten - to guess
der Kompromiss - compromise
bequem - comfortable
unglücklich - unhappy
wahnsinnig (ugs.) - incredibly
den Weg finden - to find the way
die Welt - the world
definitiv - definitely
reflektieren - to think about
glücklich - happy
kosten - to cost
verrückt - crazy
notwendig - necessary
Frage stellen - to ask a question
die Gedankenwelt - world of thoughts
reduzieren - to reduce
die Möglichkeit - possibility
persönlich - personal
sich mit etw. anfreunden - to get used to the idea of
die Bremse - brake
das Gehirn - brain
der Körper - body
die Faulheit - laziness
die Neigung - the tendency
spazieren gehen - to take a walk
das Zitat - quote
jdm. etw. vorlesen - to read sth. to sb.
sammeln - to collect
die Nacht - night
die Küche - kitchen
das Bett - bed
der Rechner - computer
die Katze - cat
stumpf - blunt
sich entspannen - to relax
etw. veröffentlichen - to publish sth.
etw. bestätigen - to confirm sth.
die Vorlesung - lecture
die Urgeschichte - prehistory
faszinieren - to fascinate
die Uhr - the clock
entstehen - to be created
entwickeln - to develop
die Kunst - art
jdm. etw. vorschlagen - to propose sth. to sb.
verprügeln - to beat up
gewalttätig - violent
der Überfall - attack
verherrlichen - to glorify
die Gewalt - violence
die Droge - drug
der Muskel - muscle
lächerlich - ridiculous
der Spaß - fun
der Sinn des Lebens - the meaning of life
die Ecke - corner
versuchen - to try
die Beziehung - relationship
etw. erkennen - to realize sth.
die Realität - reality
die Spitze - the peak
wunderbar - wonderful
das Ergebnis - result
die Annahme - assumption
glauben - to believe
gesund - healthy
die Bedeutung - meaning
die Meinung - opinion
wichtig - important
lachen - to laugh
traurig - sad
tiefgreifend - far-reaching
das Wissen - knowledge
geben - to give
nehmen - to take
das Lebewesen - living being
unterstützen - to support
eine Rolle spielen - to play a role
die Frage - question 
das Glück - happiness
vielschichtig - layered
der Fall - case
fortgeschritten - advanced
verwirrt - confused
verloren - lost
das Liebesleben - love life
unabhängig - independent
verkatert - hung-over
der Februar - February
nerven - to annoy
die Schicht - layer
empfinden - to feel
zustimmen - to agree
erreichen - to reach
auf etwas achten - to pay attention to something
tiefgründig - profound
weinen - to cry
die Ebene - level
die Entscheidung - decision
die Krankheit - disease
leiden - to suffer
die Willenskraft - willpower
verändern - to change
von etw. abhängen - to depend on sth.
der Mensch - human being
die Anzahl - number
die psychische Erkrankung - mental disorder
die Gesellschaft - society
sich entwickeln - to develop
der Umstand - circumstance
die Aufmerksamkeit - attention
etw. steuern - to control sth.
tagsüber - during daytime
wegstecken - to put away
trainieren - to train
zurückkommen - to come back
die Spirale - spiral
anfangen - to start
lenken - to direct
der Atem - breath
ablenken - to distract
die Fähigkeit - ability
zusammenhängen - to be connected
der Alltag - daily life
betonen - to point out
die Übernahme - acceptance
die Verantwortung - responsibility
der Zustand - state 
überleben - to survive
der Kater - hangover
das Bier - beer
die Langeweile - boredom
nichts zu tun - nothing to do
scheiße (ugs.) - shit (colloq.)
die Bewusstseinsstufe - level of consciousness
erlauben - to allow
übernehmen - to take over
Entscheidung - decision
weitermachen - to continue
reden - to talk
richtig - right
falsch - wrong
das Verständnis - the understanding
die Sicherheit - security
die Gleichung - the equation
die Unsicherheit - uncertainty
wackelig - shakey
das Gebäude - building
gläubig - believing
handeln - to act
altruistisch - altruistic
sich benehmen - to behave onself
lesen - to read
das Herz - heart
das Gefühl - feeling
die Erklärung - explanation
wandeln - to convert
der Fehler - mistake
wissen - to know
das Gegenteil - opposite
die Beschreibung - description
das Ding - thing
der Sklave - slave
die Frau - woman
das Recht - the law
abstimmen - to vote
Vergangenheit - the past
die Zukunft - the future
heutige Zeit - present time
spezifisch - specific
das Beispiel - example
betrachten - to consider
offen - open
etw. dabei belassen - leave sth. at that
die Überraschung - surprise
vorbereiten - to prepare
einfach - easily
frei - free
unheimlich (ugs.) - incredibly (colloq.)
die Angst - fear
feststellen - to state
die Redewendung - expression
beschreiben - to describe
deswegen - therefore
die Sprache - language
der Schwamm - sponge
drüber - above
der Streit - dispute
etw. falsch machen - to do sth. wrong
vergessen - to forget
die Sorge - concern
wischen - to wipe
der Tisch - table
der Krümel - crumb
frisch - fresh
etw. beenden - to end sth.
das Wirtshaus - tavern
das Getränk - beverage
der Bierdeckel - beer mat
die Kreide - chalk
die Tafel - board
zahlen - to pay
zu Hause - at home
beschweren - to complain
auffallen - to notice
Silvester - New Year's Eve
erlaubt - allowed
das Feuerwerk - fireworks
die Rakete - rocket
die Stange - stick
der Zünder - detonator
der Krach - noise
der Daumen - thumb
laut - loud
etw. benutzen - to use sth.
vorher - before
später - later
die Kreuzung - intersection
erschrocken - shocked
zusammenzucken - to flinch
rasen - to speed
haargenau (ugs.) - exactly (colloq.)
die Feinstaubbelastung - fine dust pollution
das Jahr - year
das Geld - money
die Verletzung - injury
abbrennen - to burn down
das Feuer - fire
gerechtfertigt - justified
Hinz und Kunz (ugs.) - every Tom, Dick and Harry (colloq.)
das Risiko - risk
der Nachteil - drawback
bemerkenswert - remarkable
sperren - to block
das Ausland - foreign countries
die Veranstaltung - event
reichen - to be enough
erinnern - to remember
der Supermarkt - supermarket
der Baumarkt - hardware store
verkaufen - to sell
das Novum - novelty
bald - soon
etw. abschaffen - to get rid of sth.
unterwegs - on the way
der Südafrikaner - South African
das Gegenstück - counterpart
die Schweiz - Switzerland
Weihnachten - Christmas
das Gerät - device
die Mitte - center
die Pfanne - pan
die Kartoffel - potato
das Fleisch - meat
der Schinken - ham
der Käse - cheese
braten - to fry
der Hunger - hunger
schön - nice
eigen - own
sich unterhalten - to chat
erwähnen - to mention
die Empfehlung - recommendation
vollgefressen (ugs.) - to be stuffed (colloq.)
komisch - weird
die Weihnachtsfeier - Christmas party
das Büro - office
förmlich - really
der Gesichtsausdruck - face expression
die Gurke - cucumber
der Ernst - seriousness
das Abendessen - dinner
die Mahlzeit - meal
das Essen - food
essen - to eat
stundenlang - for hours
voll sein - to be stuffed
der Freund - boyfriend
zum ersten Mal - for the first time
ehrlich - honestly
spannend - exciting
etw. wahrnehmen - to be aware of sth.
lecker - delicious
nachvollziehen - to follow
sich erinnern - to remember
jagen - to hunt
langsam - slow
die Vorstellung - the idea
die Brotzeit - meal involving bread and spreads
der Ort - place
das Brot - bread
der Punkt - point
sich vorstellen - to imagine 
der Nahe Osten - the Middle East
das Nahrungsmittel - food
die Suppe - soup
satt - fed up
grundsätzlich - generally
das Buch - book
norwegisch - Norwegian
der Autor - author
der Erwachsene - adult
etw. empfehlen - to recommend sth.
zusammenfassen - to summarize
das Mädchen - girl
der Brief - letter
die Geschichte - history
übersetzen - to translate
anschließen - to follow
der Klimawandel - climate change
unternehmen - to take action
sich vorstellen - to imagine
die Stadt - town
betroffen sein - to be affected
der Nordpol - North Pole
die Insel - island
die Entwicklung - development
der Globus - globe
warm - warm
das Eis - ice
der Fisch - fish
die Karte - map
die Bewegung - movement
konkret - specifically
abgeklärt - detached
die Frage - question
beziehungsweise - or rather
mittlerweile - in the meantime
Menschen - people
die Fremdsprache - foreign language
Polen - Poland
spezifisch - specifically
alleine - alone
die Muttersprache - mother tongue
perfekt - perfectly
Polnisch - Polish
die Zeichnung - drawing
der Platz - space
das Sprachzentrum - language centre
verhältnismäßig - relatively
das Werkzeug - tool
arbeiten - to work
deshalb - therefore
die Färbung - here: influence
der Alltag - everyday life
ständig - permanently
das Nachdenken - pondering
die ganze Zeit - the whole time
der Flüchtling - refugee
müssen - to have to
begabt - talented
gescheitert - failed
Französisch - French
etw. erwarten - to expect sth.
auf der anderen Seite - on the other side
dabei bleiben - to stick to it
Polyglottie - multilingualism
etw. zu sagen haben - to have sth. so say
sich kurz fassen - to be brief
ausgeprägt sein  - to be pronounced 
Niederländisch - Dutch
studieren - to study
keine Ahnung - no idea
die Zeitung - newspaper
nach einer Weile - after a while
die Bevorzugung - preference
das Niveau - level
nach … ziehen - to move to …
der Fortschritt - progress
der Kurs - the course
besuchen - to visit
irgendwann - someday
sich freuen - to be happy
das Neujahr - New Year
der Vorsatz - resolution
beginnen - to begin
das nächste Mal - next time
die Höhe - height
das Schlusswort - final word