Frohe Weihnachten - Merry Christmas
mitsingen - to sing along
sich zurückhalten - to restrain oneself
dumm - foolish
klingen - to sound
lauthals - loudly
manchmal - sometimes
zu Gast sein - to be a guest
sich daneben benehmen - to act up
der Tisch - table
der Spruch - saying
Mittag essen - to have lunch
als Kinder - as children
früher - in former times
im Krieg - during the war
die Auswahl - selection
der Einstieg - introduction
Weihnachten - Christmas
zu Feier des Tages - to mark the occasion
das Geschenk - gift
die Vokabelhilfe - vocabulary helper
das Kapitelbild - chapter image
unterstützen - to support
beim Zuhören - while listening
die Übersetzung - translation
für alle - for everyone
das Mitglied - member
die Aufforderung - request
die Bitte - plea
sich überlegen - to consider
helfen - to help
wissen - to know
hauptberuflich - full-time
ausschließlich - solely
verdienen - to earn
mittlerweile - by now
die Freude - joy
die Werbung - advertising
nervig - annoying
tolle Arbeit machen - to do a great job
in Anspruch nehmen - to take up
die Vorbereitung - preparation
die Aufnahme - recording
der Schnitt - editing
dahinter stecken - to be behind it
etw. offen darlegen - to disclose sth. openly
erklären - to explain
etw. gerne machen - to be happy to do sth.
die Unterstützung - support
auf etw. angewiesen sein - to rely on sth.
sich finanzieren - to finance oneself
ausschließlich - exclusively
grundsätzlich - in principle
etw. bewerben - to advertise sth.
die Matratze - mattress
die Anfrage - inquiry
hassen - to hate
in der Zukunft - at some point in the future
die Bahn - train
über etw. berichten - to report on sth.
jmd. sponsern - to sponsor sb.
kostenlos - for free
keine Ahnung - no idea
sich anbieten etw. zu tun - to volunteer to do sth.
die Seele - soul
verkaufen - to sell
freiwillig - voluntarily
etw. mögen - to be fond of sth.
am allermeisten - most of all
etw. gefällt jmd. - sb. likes sth.
etw. zurückgeben - to give sth. back
das Verhältnis - relationship
jmd. folgen - to follow sb.
das Weihnachtsfest - Christmas
jmd. etw. bereiten - to afford sb. sth.
bedeuten - to mean
zahlen - to pay
das Schöne - the wonderful thing
das Forum - discussion board
die Sprachpartnerin - language partner
die Moderatorin - hostess
viel los sein - to be very lively
reingucken - to take a look at
schneiden - to edit
langsam - slow
am Ende - in the end
die Stunde - hour
geil - awesome
gleich - in a moment
vorlesen - to read aloud
sich auf etw. freuen - to look forward to sth.
heute Nacht - last night
der Nachname - surname
deswegen - that's why
witzig - funny
an dieser Stelle - at this point in time
der Nutzer - user
scheiße - shit
das Geile (ugs.) - the amazing thing (colloq.)
etw. vorbereiten - to prepare sth.
Spaß haben - to have fun
die Sendung - show
automatisch zuhören - to listen automatically
laut - out loud
die Küche - kitchen
hören - to listen to
die Leute - people
bis zum Ende - until the end
gute Laune haben - to be in a good mood
der Ohrwurm - catchy tune
abschalten - to switch off
über etw. nachdenken - to think about sth.
wahrscheinlich - probably
feiern - to celebrate
erzählen - to talk about
das Land - country
anders - different
der Feiertag - holiday
zusammenkommen - to come together
ähnlich - similar
der Kern - the gist
die Ausrichtung - orientation
so viel … wie möglich - as much ... as possible
verstehen - to understand
der Einzelhandel - retail
arbeiten - to work
das Geschäft - shop
Silvester - New Year's Eve
das Einkaufszentrum - shopping mall
nochmal - again
umtauschen - to return
das Geld - money
Zeit mit jmd. verbringen - to spend time with sb.
zusammensitzen - to sit together
das Wohnzimmer - living room
lesen - to read
gut essen - to eat well
Bitte nicht! - Please don't!
etw. bereuen - to regret sth.
der Arme - the poor guy
das Weihnachtsgeschenk - Christmas gift
das tollste - the greatest
je - ever
in Erinnerung bleiben - to stick in one's mind
nachdenken - to think
sich erinnern - to recollect
wahnsinnig - incredibly
beantworten - to answer
anrufen - to call
Besorgungen machen - to run errands
Süße - Sweetie
aufnehmen - to record
sich erinnern - to recall
aufgeregt sein - to be excited
Keine Ahnung! - No idea!
bauen - to build
die Carrera-Bahn - slot car
in den Startlöchern stehen (ugs.) - to be ready (colloq.)
das Gleiche - the same thing
warten - to wait
fragen - to ask
kriegen - to get
ungefähr - roughly
aufregend - exciting
macht nichts - it doesn't matter
gucken - to take a look at
der Karton - box
einkaufen - shopping
schöne Grüße - best regards
die Rennbahn - racetrack
im Kreis - in a circle
die Fernsteuerung - remote control
das Autorennen - car race
der Fußboden - floor
kaputt gehen - to break
spätestens - at the latest
vergehen - to pass
der Spielzeughersteller - toy manufacturer
die Autorennbahn - race track
verwenden - to use
die Eltern - parents
das Geschenk - present
brauchen - to need
sich verschlucken - to choke on sth.
heutzutage - nowadays
gefährlich - dangerous
rumfliegen - to fly around
lassen - to let
als Kind - as a child
der Weihnachtsmann - Santa Claus
an etw. glauben - to believe in sth.
das Christkind - 'Christ-child'
etw. herausfinden - to learn sth.
abhängig von - depending on
Süddeutschland - Southern Germany
komisch - strange
die Abwandlung - variation
recherchieren - to do research
überwiegend - mainly
die Gegend - area
verbreitet sein - to be common
so eine Art - a kind of
der Engel - angel
glauben - to believe
während - during
die Bescherung - giving of Christmas presents
der Baum - tree
aufreißen - to rip open
das Jahrhundert - century
im Zuge - in the wake of
die Heiligenverehrung - veneration of the saints
etw. beseitigen - to eradicate sth.
das Weltbild - world view
ersetzen - to replace
Gestalt annehmen - take form
der Säugling - newborn
die Krippe - crib
mehrfach - several times
der Adventskalender - advent calendar
die Süßigkeit - candy
unter keinen Umständen - under no circumstances
die Glocke - bell
läuten - to ring
zum Abschied - as a goodbye
runter - down
rasen - to race
rennen - to run
gesittet zugehen - to be civilized
der Jahresrückblick - review of the year
auf etw. zurückschauen - to look back on sth.
zusammenfassen - to summarize
aufmachen - to open
die häufigsten - the most frequent
der Suchbegriff - search term
angesagt sein - to be talked about
traurig - sad
verschwinden - to disappear
auftauchen - to turn up
die Vermisste - missing woman
brennen - to burn
sterben - to die
der Schacht - shaft
fallen - to fall
die Was-Frage - what-question
die Rolle - role
übernehmen - to take over
aus dem Stehgreif - off the cuff
am häufigsten - most frequently
das EU-Gesetz - the EU law
blocken - to block
hochladen - to upload
gegen etw. protestieren - to protest against sth.
Internet-affin - Internet-savvy
reglementieren - to regulate
kontrollieren - to control
sich mit etw. beschäftigen - to engage with sth.
die Nacht - night
entscheiden - to decide
die Entscheidung - decision
wählen - to vote
die Wahl - the election
wenigstens - at least
bewusst - deliberately
sich entscheiden - to choose
krass - crazy
hinterherrennen - to run after
das Sperrgebiet - restricted zone
forschen - to do research
die Raumfahrt - space travel
die Verschwörungstheorie - conspiracy theory
etw. mitbekommen - to be aware of sth.
sich verabreden - to arrange to meet
etw. überlaufen - to overrun sth.
Im Ernst? - Seriously?
jmd. aufhalten - to stop sb.
reingehen - to go inside
die Androhung - threat
notfalls - if necessary
die Gewalt - violence
verteidigen - to defend
die Militärbasis - military base
etw. überfallen - to raid sth.
auf dumme Ideen kommen - to come up with stupid ideas
gar nicht so schlecht - not all that bad
besprechen - to discuss
spannend - fascinating
das Akronym - acronym
tippen - guess
unnötig - unnecessary
unnütz - useless
nochmal besser - even better
der Inbegriff von - the epitome of
angeblich - allegedly
der Geländewagen - off-road vehicle
die Farm - farm
tiefes Wasser - deep water
unwegsames Gelände - uneven ground
der Stein - rock
der Schotter - gravel
stecken bleiben - to get stuck
der Grund - reason
mittlerweile - currently
der Großteil - majority
die Neuzulassung - new registration
verbrauchen - to consume
der Unfall - accident
völlig unnötig - utterly unnecessary
das Vorurteil - prejudice
die dicke Karre (ugs.) - the big car (colloq.)
einsteigen - to get in
die Leiter - ladder
die Wüste - desert
der Allradantrieb - four-wheel drive
der epileptische Anfall - epileptic attack
am Steuer - behind the wheel
mehrere - several
bei uns um die Ecke - around the corner from us
der Bürgersteig - sidewalk
der Poller - pole
der Metallstab - metal rod
der Gehweg - footpath
beschützen - to protect
jmd. überfahren - to run sb. over
der Spiegel - mirror
das Spielzeugauto - toy car
zu Hause - at home
der Lebensinhalt - purpose in life
leid tun - to be sorry
bequem - comfortable
etw. verstehen - to understand sth.
die Angst - fear
sicherer - safer
der Kampfjet - fighter jet
kaufen - to buy
Kann das sein? - Is that possible?
herstellen - to produce
glauben - to think
handgemacht - handmade
die Fabrik - factory
per Hand - by hand
zusammenschrauben - to screw together
irgendeine Zahl - any number
teuer - expensive
ein Schnäppchen (ugs.) - a steal (colloq.)
netto - before tax
die Mehrwertsteuer - value added tax
billo (ugs.) - cheap (colloq.)
das Wohngebiet - residential area
sich vorbereiten - to prepare
die Nachrichten - the news
die Wie-Frage - how-question
die Biene - bee
die Arbeiterin - worker (bee)
der Bienenstaat - bee colony
die Dauer - duration
die Arme - the poor thing
Quatsch reden - to talk nonsense
das gefällt mir - I like that
etw. vorschlagen - to propose sth.
sich unterhalten - to talk
fliegen - to fly
der Ausdruck - expression
englischsprachig - english speaking
komisch - odd
holen - to get
etw. benötigen - to need sth.
etw. besorgen - to get sth.
die Besorgung - errand
ehrlich gesagt - to be honest
etwas erledigen - to run an errand
dazu passen - to go well with it
die Tätigkeit - activity
Dinge erledigen - to get things done
anfangen - to start
benutzen - to use
das Partizip - the participle
erledigt - done
zurückschreiben - to write back
praktisch - handy
die Weihnachtszeit - festive season
die Lieblingskategorie - favorite category
offensichtlich - apparently
sich aufregen - to get worked up
Pillepalle (ugs.) - irrelevant (colloq.)
das Leitungswasser - tap water
die Weltgemeinschaft - world community
der Klimawandel - climate change
die Weltklimakonferenz - World Climate Conference
aufhalten - to stop
verlangsamen - to slow down
in aller Munde sein - to be the talk of the town
der Wissenschaftler - scientist
vorrechnen - to calculate
weiter wie bisher - business as usual
enthalten - to contain
die Erderwärmung - global warming
überschreiten - to exceed
eine Katastrophe unheimlichen Ausmaßes - a disaster of unimaginable proportion
sich etw. vorstellen - to envision sth.
die Hungerskatastrophe - famine catastrophe
die Flut - flood
die Trockenheit - drought
mit viel Glück - if fortunate
sich zügeln - to restrain oneself
sich vorstellen - to introduce oneself
passieren - to happen
trotzdem - nevertheless
sich treffen - to assemble
auf dem Tisch sein (ugs.) - to be on the table (colloq.)
wirtschaftlich - economic
das Wohl - well-being
die Menschheit - humanity
wütend - angry
die Stimmung einfangen - to save the mood
treffen - to meet
einladen - to invite
das Tolle - the great thing
aus aller Welt - from around the world
die Altersgruppe - age group
die Geschichte - story
jmd. kennenlernen - to get to know sb.
der Zahnarzt - dentist
die Praxis - doctor's office
jmd. besuchen - to pay sb. a visit
der Freund - boyfriend
jmd. erkennen - to recognize sb.
ungefähr - approximately
die Wahl - election
gewinnen - to win
keine Chance haben - to stand no chance
etw. ausrechnen - to calculate sth.
das Wahlsystem - electoral system
mathematisch unmöglich - mathematically impossible
sich erinnern - to remember
sich schämen - to be embarrassed
die Aussage - statement
lachen - to laugh
jetzt haben wir den Salat (ugs.) - now we're in a fine mess (colloq.)
reisen - to travel
einen Job annehmen - to accept a job
entwickeln - to develop
sich uneinig sein - to be in disagreement
eigentlich - actually
umgekehrt - the other way around
der richtige Name - real name
die Empfehlung - recommendation
der Hammer (ugs.) - the amazing thing (colloq.)
etw. gründen - to found sth.
sich mit jmd. anfreunden - to befriend sb.
der Softwareentwickler - software developer
gestern - yesterday
die Veranstaltung - event
verwechseln - to confuse
der Witz - joke
nennen - to call
die Nummer Zwei - number two
gefallen - to like
zuhören - to listen
liebe Grüße - best regards
jmd. treffen - to come across sb.
einfallen - to occur
doof - stupid
trotzdem - anyway
das Tagebuch - journal
jeden Tag - on a daily basis
schreiben - to write
als allererstes - first off
im Kopf - on sb.'s mind
das Wort - word
wenig - little
korrigieren lassen - to have it corrected
sich zwingen - to force oneself
hören - to listen
jeden Morgen - every morning
der Fehler - mistake
die Weihnachtsfeier - Christmas party
zusammen - together
die U-Bahn - subway
aufwachen - to wake up
verdammt - damn
betrunken - drunk
jmd. mit etw. anstecken - to infect sb. with sth.
das Leben - life
geordnet - organized
etw. bereuen - to have regrets about sth.
etw. anrichten - to cause sth.
solange - as long as
um etw. gehen - to be about sth.
mitbringen - to bring along
einschleichen - to sneak in
die Tage (ugs.) - these days (colloq.)
etwas getrunken haben - to have had a drink
rauslassen - to let out
die Woche - week
der Abend - evening
Geh ran - Pick up the phone
ein Freund - a friend
nicht mehr da sein - to no longer be there
erfahren - to learn about
unspektakulär - unspectacular
der Nachruf - obituary
der Film - movie
weinen - to cry
nahe gehen - to affect
lustig - funny
beziehungsweise - or rather
berühmt - famous
die andere - the other one
erwähnen - to mention
entstehen - to originate
das Kind - child
rausbringen - to publish
Die Roten Rosen - The Red Roses
das Weihnachtslied - Christmas Carol
das Dach - roof
vor allen Dingen - more than anything
lieben - to love
rauf und runter hören - to listen non-stop
zum Leid - to the sorrow of
die Großeltern - grandparents
übersetzen - to translate
verlinken - to link to
immer noch - still
nostalgisch - nostalgic
sich zurückversetzt fühlen - to feel transported back
die Kindheit - childhood
jmd. zu nahe treten - to offend sb.
schlimm - terrible
mit gutem Gewissen - in good conscience
ganz ehrlich - to be honest
das Nostalgie-Ding - matter of nostalgia
furchtbar - horrible
Recht haben - to be right
wie jmd. etw. findet - to how sb. likes sth.
ausschalten - to switch off
mal wieder - once again
der Buchstabe - letter
hintereinander - one after the other
die Frage - question
motivieren - to motivate
sich geschätzt fühlen - to feel valued
die Anerkennung - recognition
erzählen - to tell
gleich - in a second
regnen - to rain
die wichtigste - the most important
überzeugt - convinced
glücklich - happy
merken - to notice
deswegen - that' s why
wichtig - important
der Zuhörer - listener
der Zuschauer - viewer
zu etw. aufrufen - to make a plea for sth.
der Beruf - profession
die Grundmotivation - main motivation
verfügbar - available
sich gut verstehen - to get along well
auf einer Wellenlänge sein - to be on the same wavelength
übereinander - about each other
der Zugang - access
beschreiben - to describe
hinzufügen - to add
gründen - to start
unglaublich viele - an incredible number
einfach - easy
etwas zu sagen haben - to have something to say
das Tolle am Internet - the great thing about the internet
das Gefühl - feeling
umso besser - even better
sich hinsetzen - to sit down
hilfreich - helpful
meine eigenen - my own
niemand anderes - nobody else
aus Prinzip - on principle
reden - to talk
stören - to bother
sich anpassen - to conform
die Meinung - opinion
sich selbst zensieren - to self-censor oneself
mit etw. rechnen - to expect sth.
etw. falsch verstanden - to misconceive sth.
der Flüchtling - refugee
der Hass - hatred
sich etw. vornehmen - to plan to do sth.
sich um etw. kümmern - to deal with sth.
Bescheid wissen - to know
der Hasskommentar - hate comment
löschen - to delete
verbannen - to block
sich ausdrücken - to express oneself
Lust haben - to want to
artikulieren - to articulate
die Gleichberechtigung - equal rights
kapern - to hijack
frauenverachtend - misogynistic
reingehen - to enter
stören - to disrupt
kaputtmachen - to destroy
nerven - to annoy
vorsichtig - cautious
anstoßen - to be controversial
sich Sorgen machen - to be worried
etw. falsch verstehen - to misconceive sth.
die Hürde - hurdle
sich freuen - to be happy
Bock haben (ugs.) - to want to (colloq.)
sich unterhalten - to talk to
der Austausch - exchange
möglich - possible
etw. unterschreiben können (ugs.) - to agree (colloq.)
nicken - to nod
die Feiertage - the holidays