das Pfeifen - whistling
das Bonbon - the candy
essen - to eat
Wie geht's dir? - How are you?
die Woche - the week
schwierig - difficult
die Frage - the question
kein Mensch (ugs.) - nobody (colloq.)
der Mülleimer - the trash can
die Verschwendung - the waste
sich erinnern - to recall
das Kurzzeitgedächtnis - the short-term memory
treffen - to meet
loslegen - to get started
bereit - ready
die Überraschung - the surprise
das gleiche - the same
sich kurz fassen - to be brief
etw. beschließen - to decide on sth.
ist doch egal - it doesn't matter
das Reisen - traveling
nachdenken - to ponder
der Zuhörer - the listener
von etw. angesteckt werden - to be infected with sth.
die Begeisterung - the enthusiasm
von etw. träumen - to dream of sth.
die Sprache - the language
sich mit etw. beschäftigen - to engage with sth.
in ein Land ziehen - to move to a country
recht haben - to be right
etw. betrifft jmd. - sth. concerns sb.
die Schule - the school
rein - pure
der Zwang - the obligation
das Schulfach - the school subject
wählen - to elect
vorkommen - appear
krass (ugs.) - crazy (colloq.)
anfangen - to begin
die Grundschule - primary school
etw. davon halten - to approve of sth.
je … desto - the ... the more
spielerisch - playfully
pauken (ugs.) - cramm (colloq.)
die Kindheit - the childhood
hassen - to hate
bescheuert - stupid
stumpf - bluntly
entwickeln - to develop
Sinn machen (ugs.) - to make sense (colloq.)
teilweise - in part
erstrebenswert - worth striving for
das Austauschjahr - the exchange year
plötzlich - all of a sudden
was etw. betrifft - with regard to sth.
das Gefühl - the feeling
peinlich - awkward
die Hürde - the barrier
damals - back then
ausgebildet werden - to be trained
die Möglichkeit - the possibility
das Ausland - abroad
die Geschenkkultur - the gift culture
auffallen - to notice
empfangen - received
verrückt - crazy
schlecht - bad
mitgeben - to give along
das Gastgeschenk - the host gift
die Heimat - the home country
die Ideen ausgehen - to run out of ideas
schwach - weakly
schenken - to make a present
die Eltern - the parents
eingeladen werden - to be invited
die Flasche - the bottle
die Blume - the flower
gemeinsam - together
erwarten - to expect
empfangen - to receive
ausgeprägt - pronounced
das schlechte Gewissen - the guilty conscience
kriegen - to get
wegwerfen - to discard
peinlich - embarrassing
etw. geheim halten - to keep sth. a secret
das Geschenk - the gift
der Wahnsinn - madness
die Knarre (ugs.) - the gun (colloq.)
die Pistole - the pistol
der Bilderrahmen - the picture frame
der Plastikdiamant - the plastic diamond
das Witzige - the funny thing
der Schüleraustausch - the student exchange
die Begleitung - the chaperon
der Koffer - the suitcase
die Uhr - the watch
der Säbel - the saber
die Klamotten - the clothes
das Kostüm - the outfit
der Umhang - the cape
das Gewand - the robe
die Tasse - the cup
die Erinnerung - the memory
der Stift - the pen
leid tun - to be sorry
die Wahrheit - the truth
die Zuschauerin - the viewer
wertvoll - valuable
der Geldschein - the banknote
die vorherige - the previous
die Währung - the currency
das Peinliche - the embarrassing thing
etw. macht jmd. fertig (ugs.) - sth. really bugs sb. (colloq.)
der Flohmarkt - the flea market
der Rucksack - the backpack
mitnehmen - to take (home)
das Kamel - the camel
Schluss sein (ugs.) - to be enough (colloq.)
hinstellen - to put down
die Vitrine - the cabinet
gleichzeitig - at the same time
unhöflich - impolite
die Kiste - the box
sich freuen - to rejoice
die Tüte - the bag
das Essen - the food
lieb - kind
die Sache - the thing
hervorheben - to highlight
besuchen - to visit
zu Gast sein - to be a guest
der Vortrag - the lecture
arbeiten - to work
der Abschlussabend - the final evening
zum Abschluss - at the end
handgeschrieben - handwritten
unterschrieben - signed
die Lehrerin - the teacher
vorbereiten - to prepare
die Handtasche - the purse
der Hund - the dog
etw. auf den Kopf stellen - to turn sth. upside down
etw. aufessen - to eat sth. up
übrig bleiben - to be left
um etw. kämpfen - to fight for sth.
zusammenkleben - to glue together
die Hälfte - one half
fehlen - to be missing
zerrissen - torn
das Büro - the office
die Wand - the wall
die Geschichte - the story
die Enttäuschung - the disappointment
die Reizüberflutung - the sensory overload
der Reiz - the stimulus
etw. wahrnehmen - to perceive sth.
das Geräusch - the sound
der Sinn - the sense
die Berührung - the touch
hören - to hear
sehen - to see
riechen - to smell
schmecken - to taste
geruchsintensiv - odorous
jmd. überfordern - to overwhelm sb.
überfordern - to overtax
zu viel - too much
der Klassiker - the classic example
der Ort - the place
der Unterschied - the difference
reich - rich
der Bundesstaat - the State
krass - stark
bekannt - well-known
heilig - sacred
der Fluss - the river
dermaßen - so
das Verkehrsmittel - the means of transport
das Tier - the animal
die Kuh - the cow
die Gasse - the alley
hupen - to honk
das Schild - the sign
aufhören - to stop
das Autofahren - the driving (car)
sich vorstellen - to imagine
die Lärmbelastung - the noise pollution
etw. betreffen - to concern sth.
etw. vertragen - to tolerate sth.
umgeben sein - to be surrounded
der Eindruck - the impression
die Gewöhnungssache - the matter of habituation
ruhig - tranquil
verschlafen - sleepy
die Ecke - the corner
die Großstadt - the big city
hart sein - to be tough
etw. erinnert jmd. - sth. reminds sb.
der Besuch - the visit
gefühlt - seemingly
der Stau - the traffic jam
zu jeder Sekunde - at every second
meckern - to moan
reisebegeistert - travel-enthusiastic
gefallen haben - to have liked it
komisch - strange
sich heraustellen als - to turn out to be
bevölkerungsreich - populous
drumherum - around
die U-Bahn - the subway
der Bahnhof - the station
heiß - hot
sauber - cleanly
geordnet - orderly
eine Oase der Ruhe - an oasis of calm
überidealisieren - overidealize
im Rückblick - in retrospect
drängeln - to shove
der Dreck - the dirt
der Boden - the floor
das Fenster - the window
zerkratzt - scratched
das Gemälde - the artwork
die Kotze - the vomit
wegwischen - to wipe away
der Vorabend - the night before
respektvoll - respectful
sich verhalten - to act
tief - deeply
verwurzelt - rooted
aufeinander Acht geben - to be considerate of each other
ständig - constantly
mit jmd. zusammenprallen - to collide with sb.
umsichtig - wary
sich erinnern - to remember
seit langer Zeit - for a long time
die Jugend - the adolescence
die Lautstärke - the volume
die Bahn - the train
der Tunnel - the tunnel
klappern - to rattle
auseinander fallen - to fall apart
der Gummireifen - the rubber tires
die Schiene - the rail
das Eisen - the iron
der Stahl - the steel
sich ärgern - to regret
das Reisesegment - the travel segment
das Thema - the topic
versuchen - to try
herausstellen - to point out
reisen - to travel
das Schöne - the beauty
anstrengend - strenuous
zum Abschluss - in closing
vermissen - to miss
sich zurück erinnern - to remember back
das Besondere - the extraordinary
das Bild - the image
im Kopf bleiben - to stick in one's mind
das Erinnerungsvermögen - the recall ability
wahrnehmen - to perceive
der Grund - the reason
abgesehen davon - apart from that
das Verständnis - the understanding
sich ändern - to change
reicher - richer
in dem Sinne - in the sense
abgespeichert - stored
es wert sein - to be worth it
beschreiben - to describe
lebendig - alive
sich sehnen nach - to yearn for
etw. fehlt jmd. - sb. is missing sth.
die Unsicherheit - the uncertainty
fremd - unfamiliar
sich auf etw. einstellen - to adapt to sth.
das Abenteuer - the adventure
klingen - to sound
kitschig - cheesy
die Überleitung - the transition
der feste Ort - the permanent place
zurückkehren - to return
würdest du lieber - would you rather
verlassen - to leave
die Entscheidung - the decision
die Stadt - the city
bleiben - to stay
Geht das? (ugs.) - Is that possible? (colloq.)
schauen - to look / to try
sich etw. erlauben können - to be able to afford sth.
die Wohnung - the apartment
der Wunsch - the wish
der Freundeskreis - the group of friends
die Beziehung - the relationship
leiden - to suffer
pendeln - to commute
gefangen sein - to be trapped
aufwachsen - to grow up
weggehen - to go away
überhaupt mal - at all
die Freiheit - the freedom
ausbrechen - to escape
die Küche - the kitchen
der Ausdruck - the expression
zu etw. übergehen - to start doing sth.
erklären - to explain
nee (ugs.) - nah (colloq.)
kein Bock (ugs.) - I don't wanna (colloq.)
bescheuert - silly
stimmt - true
meistens - usually
ne? (ugs.) - right? (colloq.)
der Satz - the sentence
im Prinzip - basically
die Bestätigung - the confirmation
die Verneinung - the negation
etw. hinterherschieben - to tack sth. on
etw. an das Ende hängen - to add sth. to the end
wehtun - to hurt
die Zahnschmerzen - the toothache
das Hörspiel - the radio play
etw. aufzeichnen - to record sth.
der Englischunterricht - the English class
werten - to judge
Wisst ihr Bescheid, ne? (ugs.) - So now you know, right? (colloq.)
mit etw. zusammenhängen - to be related to sth.
fliegen - to take a plane
stattdessen - instead
das Lieblingstransportmittel - the preferred means of transport
der Zug - the train
das WLAN - the Wi-Fi
schimpfen - to rant
sich anschließen - to join in
die Verspätung - the delay
umgeleitet werden - to be redirected
die Schweiz - Switzerland
die Voraussetzung - the condition
pünktlich - punctually
die Grenze - the border
die Tafel - the (information) board
verantwortlich - responsible
etw. hinkriegen - to manage sth.
nerven - to be a hassle
das Formular - the form
ausfüllen - to fill out
immerhin - at least
der Servicehinweis - the service announcement
das Fahrgastrechte-Formular - the passenger rights form
krass - extreme
passieren - to transpire
die Niederlande - the Netherlands
das Serviceverständnis - the concept of service
anzeigen - to show
die Schrift - the font
unter - below
Quatsch sein (ugs.) - to be ridiculous (colloq.)
Pech haben - to have bad luck
die Wartehalle - the waiting hall
der Wartebereich - the waiting area
die Anzeige - the display
etw. durchsagen - to announce sth.
verpassen - to miss
nicht so wichtig sein - to not matter so much
jmd. böse sein - to be angry with sb.
dranhängen - to tack on
gebucht - booked
riesig - huge
keine Sekunde - not a second
sich entschuldigen - to apologize
die Tiefschlafphase - the deep sleep phase
weit entfernt - far away
die Aufwachphase - the awakening phase
der Krach - the loud noise
bohren - to drill
der Presslufthammer - the jackhammer
hämmern - to hammer
senkrecht im Bett stehen - to be upright in bed
wach sein - to be awake
was ist los - what's going on
der Nachbar - the neighbor
mitten in der Nacht - in the middle of the night
die Sparkasse - the Savings Bank branch
sauer sein - to be pissed
sich anziehen - to get dressed
runtergehen - to go downstairs
sich beschweren - to complain
der Lärmschutz - the noise regulation
gesetzlich erlaubt - legally permitted
die schwere Maschine - the heavy machinery
stänkern - to stir things up
mit Recht - rightly so
die Verständnisfrage - the comprehension question
der Bauarbeiter - the construction worker
das Werbeschild - the advertising sign
die Decke - the ceiling
die Stahlplatte - the steel plate
der Fußboden - the floor
stören - to interfere
der Bankbetrieb - the bank operation
unterbrechen - to disrupt
jmd. anschreien - to yell at sb.
die Lärmbelästigung - the noise nuisance
drohen - to threaten
einen draufsetzen - to go one step further
das Gesetz - the law
anklopfen - to knock on the door
der Eingang - the entrance
jmd. etw. vor die Nase halten - to hold sth. up to sb.'s face
der Krach - the noise
freundlich - friendly
dreist sein - to have the nerve
wach - awake
lauthals - to at the top of one's voice
musizieren - to make music
der Balkon - the balcony
grölen - to holler
sich verstecken - to hide
jmd. vorschicken - to send sb. ahead
die Lärmschutz(ver)ordnung - the noise protection regulation
die Verordnung - the regulation
die Zuschauer(innen)-Frage - the audience question
die Schönheit - beauty
das kulturelle Phänomen - the cultural phenomenon
das Museum der Dinge - the Museum of Things
die Ausstellung - the exhibition
geschmacklos - tasteless
unabhängig von - regardless of
billig - cheap
so tun, als - to pretend to be
hässlich - ugly
das Kunstgold - the artificial gold
der Kunstmarmor - the artificial marble
der Kunstfels - the artificial rock
wesentlich - essential
passend - fitting
das Urteil - the verdict
die Meinung - the opinion
über etw. nachdenken - to deliberate on sth.
menschlich - human
sich treffen - to meet
die Mischung - the combination
empfinden - to perceive
mit Sicherheit - for sure
beeinflusst - influenced
der Brauch - the custom
brauchen - to need
etw. ausklammern - to exclude sth.
einsteigen - to join in
die Untersuchung - the study
sich hingezogen fühlen - to be drawn to
aussehen - to look
anders - different
der Zusammenhang - the context
übertragen - to transfer
die Vorstellung - the idea
(auf)hängen - to hang (up)
bunt - colorful
grau - gray
gewöhnt sein - to be accustomed
verbinden - to connect
schön - beautiful
die Färbung - the tint/influence
das Gesicht - the face
das Schönheitsideal - the beauty ideal
schrecklich - horrible
geradezu - downright
abstoßend - repulsive
etw. überwinden - to get past sth.
sich anmaßen - to presume
die Antwort - the answer
der Glaube - the belief
fundiert - substantiated
verschieden - diverse
das Naturphänomen - the natural phenomenon
die Katze - the cat
das Entzücken - the delight
das Auge - the eye
die Mutter - the mother
vernachlässigen - to neglect
süß - cute
liebevoll - affectionately
die Aussage - the statement
etw. beschließen - to conclude sth.
die Empfehlung - the recommendation
anfangen - to start
bezeichnen - to signify
nachgucken - to look up
der Begriff - the term
im deutschsprachigen Raum - in German-speaking countries
sich über jmd. lustig machen - to make fun of someone
lustigerweise - jokingly
die Kartoffel - the potato
auf etw. hinweisen - to point sth. out
sich lustig machen - to make fun of
im Alltag - in everyday life
lachen - to laugh
herausfinden - to find out
kennenlernen - to get to know
der Witz - the joke
sich auskennen - to have a good understanding
umgekehrt - the other way round
sich mit etw. beschäftigen - to be concerned with sth.
passieren - to happen
beobachten - to observe
neben - next to
einparken - to park
aus Versehen - inadvertently
beschädigen - to damage
die Regel - the rule
gegen etw. verstoßen - to infringe sth.
die Stadtführung - the guided tour
kostenlos - free
trotzdem - anyway
bezahlen - to pay
freiwillig - voluntarily
das Trinkgeld - the tip
klein aber fein (ugs.) - small but sweet (colloq.)
anbieten - to offer
wie es jmd. wert ist - what it's worth to sb.
die Erfahrung - the experience
nebenbei - on the side
der Hauptberuf - the main occupation
Lust an etw. haben - to want to do sth.
der Reisende - the traveler
der Anbieter - the provider
untereinander ausmachen - to agree among each other
der Terminplan - the schedule
etw. absprechen - to agree on sth.
kommerzialisiert - commercialized
sich bewerben - to apply
kostenpflichtig - fee-based
etw. bewerben - to promote sth.
die Werbung - the advertising
auf etw. ankommen - to come down to sth.
der Sänger - the (lead) singer
bezeichnen - to call
im weitesten Sinne - in the broadest sense
gefallen - to like
unterwegs sein als - to be active as
herausbringen - to publish
ehemalig - former
die Postleitzahl - the postal code
bekannt als - known as
die Vergangenheit - the past
wohnen - to live
irgendwann - someday
die Postleitzahlenänderung - the postal code change
vierstellig - four-digit
fünfstellig - five-digit
berichten - to recount
die Wende - the German reunification
der Jugendliche - the teenager
sich verändern - to change
jmd. angreifen - to assault sb.
bedeuten - to mean
etw. verlinken - to link to sth.
die Zeit - the time
reden - to talk
die Fragenliste - the question list
lang - long
beantworten - to reply
der Grammatik-Nazi - the grammar Nazi
nennen - to call
benutzen - to use
generell - generally
vorsichtig - cautious
die Angst - the fear
der Zweite Weltkrieg - the Second World War
sich schwer mit etw. tun - to find it difficult to do sth.
ernst - serious
das Tabuthema - the taboo subject
nichts Falsches sagen - to say nothing wrong
bewusst sein - to be aware
die Ausmaße - the dimensions
die Art und Weise - the manner
etw. verarbeiten - to process sth.
das Opfer - the victim
sich über etw. lustig machen - to make fun of sth.
aufpassen - to be careful
der Vergleich - the comparison
jmd. einsperren - to imprison sb.
das Konzentrationslager - the concentration camp
die Verharmlosung - the trivialization
gewertet werden - to be seen as
etw. zu eng sehen - to be too uptight about sth.
etw. zurücknehmen - to retract sth.
die Sendung - the show
angesagt sein - to be called for
sich beschäftigen - to engage
leider - unfortunately
das Abschlusswort - the closing remarks
in diesem Sinne - with this in mind
sich verabschieden - to say goodbye
das Wochenende - the weekend
beziehungsweise - or rather
dito (ugs.) - same to you (colloq.)