soweit sein (ugs.) - to be ready
mampfen (ugs.) - to munch (colloq.)
aufgedreht sein - to be excited
vorher - earlier
die Wirkung - impact
schlecht drauf sein - to be in a bad mood
der Knopf - button
die gute Laune - good mood
sich anstrengen - to try hard
energetisiert sein - to be energized
der Duden - the German dictionary
der Energieschub - energy boost
labern (ugs.) - babble (colloq.)
deswegen - therefore
fies - mean
die Kneipe - pub
sich angemelden - to sign up
begrenzt sein - to be limited
stressig - stressful
die Sache - thing
darüber - about sth.
das Gespräch - conversation
verschiedene - various
zum Beispiel - for example
witzig - funny
nämlich - namely
der Nebenraum - the next room
zufällig - randomly
aussehen - to look like
etw. erkennen - to recognize sth.
der Fall - our case
das Gesicht - face
erstmal (ugs.) - for now 
etw. entdecken - discover sth.
geil (ugs.) - awesome
tatsächlich  - actually 
etw. anfangen - to start with sth.
irgendwann - at some point
dauern - to take time
historisch - historical
magisch - magic
schade - too bad
das Gesprächsthema - topic of conversation
etw. austauschen - to exchange sth.
Grüße bestellen (ugs.) - to send greetings (colloq.)
der Untertitel - subtitle
die Herausforderung - challenge
die Schlange - line
putzen - to clean
die Lieblingsfolge - favourite episode
wohl wissend - well aware
über etw. lachen - to laugh at sth.
darüber  - about it 
die Vorsicht - caution
mittlerweile - by now
erreichen - to reach
sprechen - to speak
beziehungsweise - respectively
eben nicht - or rather not
der Zweite - the second one
einige - a few
das Aussehen - the look 
austauschen - to exchange
der Spitzname - nickname
die Kindheit - childhood
begeistert sein - to be enthusiastic
drumherum (ugs) - around it (colloq.)
die Geschichte - story
die Saga - the legend
etw. berichten - tell about sth.
ziehen nach - to move to
das Bewerbungsgespräch - job interview
vor etw. stehen - to face sth.
die Frage - question
überwältigend - overwhelming
das Jobangebot - job offer
etw. annehmen - to accept sth.
der Umzug - move
überhaupt - anyway
die Großstadt - big city
die Kleinstadt - (small) town
der technische Fail - technical fail
gerne - with pleasure
etw. beinhalten - to involve sth.
natürlich  - of course 
das Stellenangebot - job offer
bereits - already
der Vorteil - advantage
der Nachteil - disadvantage
die Meinung - opinion
die Antwort - answer
genau - exactly
eine Frage stellen - to ask a question
das Beispiel - example
der Witz - joke
etw. nachgucken - to look sth. up
deutlich kleiner - much smaller
das Dorf  - village 
die Gemeinde - community
wunderschön - beautiful
das Meer - ocean
an … liegen - to be located at
die Region - region
etw. ausmachen - to make a difference
echt - real
der Unterschied - difference
weitere - further
anfangen - to begin with
je nachdem - depending on
die Einwohner - residents
die Reihenfolge - order
selbstverständlich - of course
ungefähr - approximately
stimmt das - is that right
gucken - to look 
auf jeden Fall - in any case
schätzen - to estimate
andersrum - the other way around
zuerst - first
knapp - barely
großflächig - extensive
die Fläche - area
kein einziges - not a single
das Hochhaus - skyscraper
übrigens - by the way
die Mentalität - mentality
etw. behaupten - to maintain sth.
bayrisch - Bavarian
übereinander - about each other
das Vorurteil - prejudice
hektisch - hectic
dreckig - dirty
als etw. empfinden  - to perceive as sth. 
wahnsinnig - insanely
irgendwie - kind of
riechen - to smell
sauber - clean
das Gefühl - feeling
Mischung  - mix 
hierhin kommen - to come here
die Atmosphäre - atmosphere
wegen - because of
die Gemeinschaft - community
genauso gut - just as well
besonders - especially
ausgeprägt - pronounced
insofern - in this regard
die Blase - bubble
trotzdem - nevertheless
völlig - completely
der Quatsch (ugs.) - nonsense (colloq.)
die Hauptstadt - the capital
in gewisser Weise - in some ways
etw. definieren - to define sth.
sagen wir mal - let's say
verwandt sein - to be related
abhängen von etw. - to depend on sth.
der Lebensstil  - lifestyle 
abhängen (ugs.) - to hang out (colloq.)
herrschen - to prevail 
rausgehen (ugs.) - to go out (colloq.)
etw. mitbekommen - to be aware of sth.
der Stadtteil - district
die Internationalisierung - the internationalization
stattfinden - to take place
in diesem Sinne - to this effect
die Teilung - division
der Regierungssitz - seat of government
sich etw. vorstellen - to imagine sth.
markant - striking
der Freundeskreis - circle of friends
entweder oder - either or
zumindest - at least
die Ampel - traffic light
das Nummernschild - license plate
der Heimatort - hometown
die Fensterscheibe - window pane
klopfen - to knock
zum ersten Mal - for the first time
wahrscheinlich - probably
ziemlich - quite
verrückt - crazy
die Tante - aunt
das Dorf - village
die Teilung - the German division
während - during
beschwerlich - difficult
verreisen - to travel
etw. empfehlen - to recommend sth.
die Erfahrung - experience
nachdem - after
unterwegs sein - to be on the way
natürlich - of course
empfinden - to feel
möglichst schnell - as soon as possible
definitv - definitely
das Exil - exile
der Spaziergang - walk
Silvester - New Year's Eve
das Fahrrad - bicycle
das Feld - field
begrenzt - limited
der Zeitraum - time period
der Großstadtmensch - city-dweller
im Alter - in one's old age
lieben - to love
das Ding ist (ugs.) - the thing is (colloq.)
feststellen, dass - to notice that
das Angebot - offer
nicht unbedingt - not necessarily
das Gewusel (ugs.) - bustle (colloq.)
über etw. sprechen - speak about sth.
der Großstadt-Fan - city dweller
verbringen - to spend
wohnen - to live
schätzen - to guess
doppelt so - twice as
sechzehntausend - sixteen thousand
die Wohnung - apartment
etw. finden - to find sth.
enorm - enormous
der Wohnungsmangel - housing shortage
der Druck - pressure
die Diskussion - debate
politisch - political
langfristig - long-term
bezahlbar - affordable
Fahrradtour - bicycle tour
die halbe Stunde - half an hour
der Rand - outskirt
auf jeden Fall - definitely
der Sommer - summer
die Hauptstraße - main road
der Autolärm - noise of cars
die Natur - nature
nervig - annoying
ähnlich - similar to
die Nische - niche
der Arbeitgeber - employer
Anschluss finden - to find connection
die Auswahl - selection
der Zusammenhalt - solidarity
manchmal  - sometimes 
gegenseitig - mutually
der Nachbar - neighbor
sich begrüßen - to greet each other
einfacher - easier
verschlossen sein - to be reserved
außerhalb - outside
erst mal - at first
aus dem Ausland  - from abroad 
einsam - lonely
das Berghain - famous Berlin Club
der Mut - courage
zuziehen - to move into the area
etw. aufbauen - to build sth. up
teilhaben an etw. - to participate in sth.
etabliert - established
versuchen - to try
am besten sein - to be best
der Austauschschüler - exchange student
die Gastfamilie - host family
eingegliedert werden - to be integrated
jmd. kennen - to know sb.
schwierig  - difficult 
plötzlich - suddenly
der Kern - core
oberflächlich - casually
aufbauen - to build
die Grundschule - elementary school
die Schulzeit - schooldays
überrascht sein - to be surprised
heutzutage - nowadays
außergewöhnlich - exceptional
der Schlüssel - key
ausgeprägt  - distinctive 
funktionieren - to function
geschätzt werden - to be appreciated
selten - rarely
der Fußball - soccer
der Zweifelsfall - in case of doubt
sich mit etw. auseinandersetzen - to deal with sth.
der Schützenverein - rifle club
der Kegelverein - bowling club
der Karneval - carnival
altbacken (ugs.) - old-fashioned
Zeit verbringen - to spend time
vorwurfsvoll - reproachful
recht haben - be right
die Kamera - camera
nett - nice
die Illusion - illusion
etw. vermitteln - to convey sth.
die Idee - idea
das Gefühl - sensation
die Schwierigkeit - difficulty
verraten - to let a secret out
selektiv - selective
ansprechen - to speak to
vermeiden - to avoid
traurig - sad
fröhlich - happy
die Aussage - statement
realistisch - realistic
der Eindruck - impression
bedenkenswert - worth considering
unfreundlich - unfriendly
gefragt werden - to be asked
irgendeine - any
stehen bleiben - to stop
die Medienkompetenz - media competence
die Mission - mission
aufwachsen - to grow up
wahrnehmen - to perceive
die Einwanderer - immigrants
langweilig - boring
grau - gray
steif - stiff
verklemmt sein - to be inhibited
verhasst sein - to be hated
der Verbrecher - criminal
die Menschheitsgeschichte - the history of mankind
sich wandeln  - to change
die Stabilität - stability
etw. prägen - to influence
sich bewusst sein - to be aware
für etw. bekannt sein - to be known for sth.
die Vergangenheit - the past
bewusst - deliberately
freundlich - friendly
menschenverachtend - inhuman
die Hauptmotivation - main motivation
der Umzug - the move
im Vordergrund stehen - to be in the foreground
die Erfahrung - the experience
beruflich - professionally
abhängig machen von - to depend upon
die Möglichkeit - possibility
das Unternehmen - company
der Ingenieur - engineer
aufgrund von - because of
die Sanktionen - sanctions
sich weiter entwickeln  - develop further 
ansässig sein - to be located
verteilt sein - to be spread out
die Firma - the firm
das ländliche Gebiet - rural area
die Sicherheit - security
etw. bieten - to offer sth.
festgelegt sein - to be determined
zustimmen - to agree
der Bewerber - applicant
bestimmte - specific
etw. gestellt bekommen - to be provided sth.
das Gehalt - salary
mittelständisch - medium-sized
der ländliche Raum - rural area
sich bemühen - to make an effort
die Arbeitskraft - worker
verschieden - various
etw. beleuchten - to examine
der Kommentar - comment
helfen - to help
sich befinden - to be located
die Abneigung - aversion
die Hektik - hektik pace
gemütlich - comfortably
demnächst - soon
umziehen - to move
etw. verwechseln - mix sth. up
permanent - all the time
und zwar - in fact
jmd. nerven - to annoy sb.
erklären - to explain
umso besser - even better
trennbar - separable
der Fehler - mistake
die Präposition - preposition
benutzen - to use
allgemein - in general
nennen - to name
speziell - specifically
die Kiste - box
schleppen  - to haul 
wechseln - to change
etw. vermischen - to mix
etw. zusammen bringen - to join sth. together
etw. erwähnen - to mention sth.
fantastisch - fantastic
der Zusatz - addition
anfügen - to add
sich umziehen - to change
Kleidung wechseln - to change clothes
ausziehen - to undress
erwähnen - to mention
oft - often
etw. weiter sagen - to keep saying sth.
etw. etablieren - to establish sth.
ein einem Rutsch - in one go
die Bedeutung - the meaning
die Arbeit - work
klingen - to sound
etw. hören - to hear sth.
die Version - version
der Hörer - listener
etw. schicken - to send sth.
die Nachricht - message
egal  - no matter 
die Sekunde - second
sich kurz halten - to make it short
scheitern - to fail
kaum - hardly
möglich - possible
wunderbar  - great 
der Lebensinhalt - purpose in life
Geld verdienen - to earn money
lieber - rather
sondern - instead
ein Video aufnehmen - to make a video
schneiden - to cut
das Abenteuer - adventure
herausgehen - to go out
der Sinn des Lebens - meaning of life
betrunken sein - to be drunk
das Mikrofon - microphone
fett - fat
weglaufen - to run away
stehenbleiben - to stop
bereichern - to enrich
die Intensität - intensity
übertrieben (ugs.) - extremely (colloq.)
das Rohmaterial - raw material
stundenlang - for hours
schnell - quick
einfach - simply
spannend - exciting
hart - hard
unbequem - inconvenient 
sich einigen - come to an agreement
unangenehm - unpleasant
genießen - to enjoy
zu etw. beitragen - contribute to sth.
zufällig - random
gratulieren - to congratulate
beglückwünschen - to congratulate
genial - brilliant
das Glück - luck
unbedingt - necessarily
gewisse - certain
die Leidenschaft - passion
ausüben - to practice
in dem Sinne - to that effect
die Aufgabe - task
jemand anderes - somebody else
erledigen - to take care of
die Form - the kind of
dünn - slim
improvisieren - to improvise
das Stück - piece
der Erfolg - success
theoretisch - theoretically
dahingestellt sein - to remain open
jmd. lassen - to let sb.
der Spaß - fun
etw. nennen - to call sth.
verabredetsein - to have an appointment
in Wirklichkeit  - actually
etw. betonen - emphasize sth.
jahrelang - for years
die Hoffnung - hope
der Beruf - profession
Videos machen - to make videos
heiraten - to get married
eklig - disgusting
die Baustelle - construction site
der Inbegriff - epitome
öde - boring
angewidert sein - to be in disgust
heulen - to cry
sich etw. vorstellen - to envision sth.
die Hochzeit - wedding
irgendwann - someday
Gitarre spielen - to play the guitar
beeindrucken - to impress
bereit sein - to be ready
heute Morgen - this morning
etw. verstehen - to understand sth.
etw. vergessen - to forget sth.
trotzdem - anyway
die Quintessenz - essence
wunderbar - wonderful
spiel doch nochmal - why don‘t you play
das Solo - solo
etw. aufnehmen - to record sth.
laufen lassen - to play
sowas wie - something like
klatschen - to clap
der Kompressor  - compressor 
sämtliche - all of the
der Spezialeffekt - special effect
alles Mögliche - all sorts of things
philosophisch - philosophical
spannend - interesting
der Einblick - insight
marxistisch - marxist
wichtig - important
im Kopf haben - to have in mind
die Empfehlung - recommendation
sich kaputtlachen (ugs.) - to die laughing (colloq.)
etw. aufzeichnen - to record
alles klar - alright 
die Vorschau - preview
die Zukunft - future 
scheinbar - apparently
drehen - to shoot
die Prognose - prediction
jmd. aufwecken - to awaken sb.
das Raumschiff - spaceship
der Campingwagen - camper van
projizieren - to project
rund - round
die Ecke - corner
großartig - great
die Dokumentation - documentation
letztens - recently
irrsinnig - insanely
sich vorstellen - to imagine
das deutsche Fernsehen - german television
Kontakt haben - to be in touch
auswandern - to emigrate
der britische Akzent - British accent
verbunden sein  - to be connected
die Polyglottin - polyglot
die beiden - both ot them
Sprachen sprechen - to speak languages
sich für etw. interessieren - to be interestedin sth.
schreiben - to write
reinhören - to give it a listen
generell - generally
spezifisch - specifically
das Wort des Jahres - the word of the year
allein dafür - even just for that
das Segment - segment
das Unwort des Jahres - the worst wordof the year
das Gegenteil - opposite
etw. ansprechen - to bring sth. up
im Grunde - basically
sich erinnern - to remember
kompliziert - complicated
aufpassen - to pay attention
das Äquivalent - equivalent
das Pronomen - pronoun
nicht so richtig - not really
etw. benutzen - to use sth.
etw. verlinken - to link to sth.
sowohl … als auch - both … and
kommen aus - to come from
das macht nichts - that doesn‘t matter
spazieren gehen - to take a walk
der Kuchen - cake
das Kochen - cooking
nachdenken - to think about
die Wäsche falten - to fold the laundry
ein Teil des Lebens - a part of life
süß - cute
existieren - to exist
die Anderen - the others
recht haben - to be right
die Zahl - number
sich hinteretw. verbergen - to liebehind sth.
wenige - few
jmd. persönlichkennen - to know sb. personally
unmöglich  - impossible 
wahrscheinlich  - probably 
Danke sagen - to say thank you
gleichzeitig - at the same time
plötzlich - all of a sudden
etw. vergessen - to forget
sich austauschen - to talk to each other
entgegenbringen - to show
übernachten - to stay overnight
freiräumen - to clear
einladen - to invite
zeigen - to show
die Begegnung - to encounter
resultieren - to result
fremd - strange
dadurch - thereby
die Art und Weise - manner
reisen - to travel
der Austausch - exchange
mögen - to like
die Einstellung - attitude
der Gedanke - thought
gewisse Dinge - certain things
treffen - to meet
tief - deep
der Vertrauensvorschuss - benefit of doubt
etw. kennen - to know sth.
ehrlich gesagt - to be honest
prädestiniert sein für - to be perfect for
intim - intimate
die Kopfhörer - headphones
das Ohr - ear
flüstern - to whisper
mit etw. anfangen - to get started with sth.
seit Anfang an - from the beginning
der Teil des Lebens - part of life
zusammen - together
Entschuldigung! - Apologies!
links - left
rechts - right
albern - goofy
die Hälfte - half
rausschmeißen - to kick out
maximal - tops
der Vorteil - the benefit
unterstützen - to support
eine Entscheidung fällen - to makea decision
das letzte Wort - final word
weg damit (ugs.) - away with it (colloq.)
quatschen (ugs.) - to chat (colloq.)