entscheiden - to decide
lauthals - out loud
gesund und munter - top fit
grundsätzlich - principally
die Sendung - show
fröhlich - cheerful
halbwegs - more or less
das Schniefen - sniffle
das Geräusch - noise
der Kuchen - cake
trocken - dry
schmatzen - to munch
verzehren - to consume
die Wohnungssuche - apartment search
der Mietendeckel - rent freeze
aufnehmen - to record
das Thema - subject
schwierig - difficult
das Gesetz - law
der Spätkauf (ugs.) - kiosk (colloq.)
erklären - to explain
der Krimi - thriller
entstehen - to be created
spannend - exciting
etw. anfechten - to contest sth.
die Miete - rent
die Maßnahme - measure
begeistert - enthusiastic
etw. ablehnen - to disapprove sth.
das Verhältnis - circumstance
etw. vorwegnehmen - to anticipate sth.
sich freuen - to be happy
das Mitglied - member
wissen - to know
letztens - recently
etw. anbieten - to offer sth.
das Transkript - transcript
mitlesen - to read along
die Vokabelhilfe - vocabulary helper
der Begriff - term
die Übersetzung - translation
jede Woche - every week
funktionieren - to work
die Leute - people
nutzen - to use
ursprünglich - initially
der Mehrwert - additional value
etw. bereitstellen - to provide sth.
von außen - from outside
eigentlich - actually
offensichtlich - obviously
neu - new
klappen - to succeed
wahnsinnig - incredibly
Zeit in etw. reinstecken - to invest time into sth.
dank … - thanks to ...
etw. aufbauen - to build sth. up
das Gerät - device
der Knopf - button
glücklich - happy
drücken - to push
Thema wechseln - to change the topic
Ja, richtig. - Yeah, right.
darüber - about that
die Stimme - voice
liebe Grüße - kind regards
etw. auslassen - to leave sth. out
überlegen - to think
die Zusammenfassung - summary
die Nachrichten - news
umgehen - to go around
die Verunsicherung - uncertainty
der Hamsterkauf - hoarding purchase
der Vorrat - stock
egal sein - to be of no interest
die Umfrage - survey
von gestern - of yesterday
der Fall - case
hinzukommen - to add
die Vorsicht - caution
Angst haben - to be afraid
der Umgang - handling
gleichzeitig - at the same time
die Zeitung - newspaper
vergleichbar - comparable
ehrlich gesagt - to be honest
das Rezept - recipe
die Nudel - noodle
das Klopapier - toilet paper
wie bekloppt - like crazy
der Lieferengpass - supply shortage
das Fernsehen - television
durchdrehen - to go crazy
Bezug nehmen auf … - to refer to...
witzigerweise - funnily enough
traurig - sad
das Nachwirken - after-effect
passieren - to happen
der Grund - reason
sterben  - to die 
der Flüchtling - refugee
die Flucht - refuge
negativ belastet - negatively loaded
in jeglichem Sinne - in any sense
fliehen - to flee
überleben - to survive
der Schutz - protection
die Möglichkeit - possibility
etw. beantragen - to apply for sth.
gezwungen werden - to be forced
etw. ausnutzen - to exploit sth.
nahe gehen - to be affected
die Ohnmacht - powerlessness
die Stimmung - atmosphere
jdn. aufnehmen - to take sb. in
das Bewusstsein - awareness
zu etw. hinführen - to lead to sth.
die Perspektive - perspective
etw. erfahren - to experience sth.
etw. widerspiegeln - to reflect sth.
knapp - short
das zieht einen runter - it makes you feel bad 
ohnmächtig - powerless
schrecklich - horrible
die schlechte Nachricht - bad news
an etw. verzweifeln - to be desperate about sth.
langweilig - boring
aufschnappen - to pick up
das Gesundheitssystem - health system
die Krankenversicherung - health insurance
der Arzttermin - doctor's appointment
die Arztrechnung - doctor's bill
Bist du bereit? - Are you ready?
vorbereiten - to prepare
einheitlich - standardized
etw. messen - to measure sth.
im oberen Bereich - in the upper range
gut aufgehoben - in good hands
ausgestattet - equipped
das Vertrauen - confidence
die Behörde - public authority
übernehmen - to pay for
die Krankenkasse - insurance company
geboren sein - to be born
sich vorbereiten - to prepare oneself
geheim - secret
deswegen - therefore
etw. auflockern - to ease sth. 
das Krankenversicherungssystem - health insurance system
aktuell - current
falsch - wrong
etw. einspeichern - to save sth.
die Überraschung - surprise
gut passen - to fit well
gespannt sein - to be excited
die richtige Antwort - correct answer
etw. einführen - to introduce sth.
das älteste der Welt - world's oldest
der Fakt - fact
etw. aufschnappen - to pick sth. up
neunundneunzig - ninety-nine
strafbar - punishable
freiwillig - voluntary
der Gewinn - profit
tatsächlich - actually
der einzige Weg - the only way
selbstständig - freelance
der Angestellte - employee
etw. abschließen - to sign a contract
scheißegal (ugs.) - to not give a shit (colloq.)
respektlos - disrespectful
die gesetzliche Krankenversicherung - national health insurance
die Privatversicherung - private insurance
der Arbeitgeber - employer
der Beamte - public official
die Bevölkerung - population
Woher wusstest du das? - How did you know that?
etw. raten - to guess sth.
der Durchschnitt - average
krank - sick
der Arbeitstag - working day
verunsichert - uncertain
Fünfzig/Fünfzig - fifty/fifty
nah dran - close by
überrascht - surprised
die Firma - company
der Extremfall  - extreme case 
etw. tolerieren - to tolerate sth.
geschützt sein - to be protected
gekündigt werden - to be fired
der Kündigungsgrund - reason for giving notice
etw. nachweisen - to prove sth.
auf etw. zu sprechen kommen - to bring sth. up
ans Eingemachte gehen (ugs.) - to get to business (colloq.)
Witze machen - to joke
die Verletzung - injury
das Vergiftung - intoxication
die Atemwegserkrankung - respiratory disease
der Schnupfen - common cold
die Grippe - influenza
der Muskel - muscle
der Rücken - back
die Krankmeldung - notification of illness
häufig - common
die Länge - length
der Bandscheibenvorfall - slipped disc
die Rückenschmerzen - back pain
Ich habe Rücken. (ugs.) - My back hurts. (colloq.)
ernst - serious
sich vorbereiten - to get ready
einsteigen - to get on board
der Zahnarzt - dentist
der Eintrag - entry
die Weltreise - world trip
nach … ziehen - move to …
gut gelaunt - in a good mood
die Zahnreinigung - teeth cleaning
die Zahnseide - dental floss
die Zahnpflege - dental care
sterben - to die
die Lebenserwartung - life expectancy
gering - low
Zähne putzen - to brush one's teeth
überflüssig - unnecessary
Menschen - people
zufällig - by chance
auffallen - to notice
etw. besprechen - to discuss sth.
das gehört dazu - this is part of it 
gesetzlich - statutory
der Unterschied - difference
angestellt - employed
unterscheiden - to differentiate
die Leistung - benefit
impfen - to vaccinate
der Urlaub - vacation
die Hälfte - half
monatlich - monthly
der Beitrag - contribution
das Konto - bank account
der Bruttolohn - gross wage
der Nettolohn - net salary
das imaginäre Gehalt - imaginary salary
alles mit drin - all included
das Krankenhaus - hospital
abrechnen - to account
Fangen wir von vorne an. - Let's start at the beginning.
der Schmerz - pain
besonders - especially
der Allgemeinmediziner - general doctor
der Hautarzt - dermatologist
bewerten - to rate
weiter gucken - to keep on looking
anrufen - to call
einen Termin machen - to make an appointment
der Nachteil - disadvantage
krankenversichert - medically insured
der Zugang - access
reinkommen - to get into
der Hausarzt - family doctor
der Ansprechpartner - contact person
gegenüber - opposite
offen haben - to be open
überraschend - surprisingly
angenehm - pleasant
sich wundern - to be surprised
die Erfahrung - experience
die Bewertung - valuation
es sagt nichts aus - it doesn't say anything
sauer - mad
die Krankheit - disease
überfordernd - overwhelming
einen Termin finden - to find an appointment
in der Umgebung - in the neighborhood
ist doch egal - it doesn't matter
faul - lazy
überzeugen - to convince
Lust haben - to be in the mood
abgewiesen werden - to be rejected
frustrierend - frustrating
die Diagnose - diagnosis
monatelang - for months
Patientenstop - no new patients
aufnehmen - to take up
unfreundlich - unfriendly
aus dem Ausland - from abroad
überfordert - overwhelmed
der Fremde - foreigner
sich schlecht fühlen - to feel sick
wahrscheinlich - probably
getrennt sein - to be separated
der Stressgrund - cause of stress
dazu kommen - to be added
die Angst - fear
nett - nice
auf den ersten Blick - at first sight
trotzdem - nevertheless
auf dem Land - in the countryside
dennoch - nevertheless
die Beschwerde - complaints
der Hautkrebs - skin cancer
die Vorsorge - medical check-up
das Medizinstudium - medical studies
in der Regel - normally
ermutigend - encouraging
eine gewisse Portion Zeit - a certain amount of time
ungewohnt - unusual
die Sprechstunde - consultation hours
ohne Anmeldung - without registration
leer - empty
akut krank - acutely ill
das Sprechzimmer - consulting room
husten - to cough
niesen - to sneeze
traurigerweise - sadly
mittlerweile - nowadays
es dauert länger - it takes longer
sich auf etw. einstellen - to prepare oneself for sth.
der Facharzt - specialist
die Überweisung - referral
der Augenarzt - eye specialist
der Kinderarzt - pediatrician
die Notfallambulanz - emergency room
sich den Fuß brechen - to break one's foot
der Rollstuhl - wheelchair
etw. ausfüllen - to fill sth. in
behandeln - to treat
die Abrechnung - accounting
den Überblick behalten - to keep an overview
jdn. hinschicken - to send sb. there
selten - rarely
alle möglichen Sachen - all sorts of things
reisebegeistert - travel enthusiastic
quatschen - to chat
auf Kosten - at the expense of
der Krankenkassenbeitrag - health insurance contribution
gesund essen - to eat well
die Vorsorgeuntersuchung - preventive medical check-up
das Übliche - the usual
vorkommen - to happen
das Wartezimmer - waiting room
ausholen - to go far afield
etw. verschreiben - to prescribe sth.
das Antibiotikum - antibiotic
der Arbeitnehmer - employee
fordern - to demand
der Krankenschein - sick note
jdn. krankschreiben - to give sb. a sick note
im Bett bleiben - to stay in bed
die Behandlung - treatment
etw. herausfinden - to find out sth.
handeln - to operate
spazieren gehen - to go for a walk
meiner Meinung nach - in my opinion
umgekehrt - reverse
Zack! (ugs.) - Zap! (colloq.)
der Vorteil - advantage
sich auskennen - to be well informed
im Umgang miteinander - in dealing with each other
rührend - touching
das Praktikum - internship
der Ellbogen - elbow
zusätzlich - additionally
unheimlich - incredibly
jdn. aufmuntern - to cheer sb. up
der Kulturschock - culture shock
Ostdeutschland - Eastern Germany
etw. wahrnehmen - to perceive sth.
leider - unfortunately
mehrfach - multiple
sich vorstellen - to imagine
eine Diagnose bekommen - to get a diagnosis
schlimm - terrible
ein Formular ausfüllen - to fill in a form
jdn. betüdeln (ugs.) - to take care of sb. (colloq.)
abwickeln - to process
Entschuldigung - Excuse me
die Anmeldung - registration
vorsichtig - carefully
unangenehm - uncomfortable
benachrichtigen - to inform
beschäftigt sein - to be busy
mehrere Nächte - several nights
nach einer Zeit - after some time
die Erwartungshaltung - expectation
angebracht sein - to be appropriate
jdn. begrüßen - to salute sb.
etw. mit Humor nehmen - to take sth. humorously
schroff - rough
die Art - the way
durchhalten - to endure
sich an etw. gewöhnen - to get used to sth.
der Selbstschutz - self-protection
die Arbeitsbedingung - condition
die Schicht - shift
die Schroffheit - harshness
der Schutzwall - protective wall
etw. entschuldigen - to pardon sth.
die Menschlichkeit - humanity
jdn. etw. vorwerfen - to blame sb. for sth.
das Symptom - symptom
die Entscheidung - decision
sich unterhalten - to chat
die Notaufnahme - emergency room
der Notfall - case of emergency
zwicken - to very slightly hurt
Mensch bleiben - to stay human
an dieser Stelle - at this point in time
das A und O (ugs.) - most important thing (colloq.)
Thema durch - topic closed
das Schlusswort - final statement
abschließend - concluding
die Pflicht - obligation
unklar - unclear
das Zwischenstadium - intermediate stage
Post kriegen - to get mail
etw. wegschmeißen - to throw sth. away
auf etw. achten - to watch out for sth.
Geld nachzahlen - to pay money later
das Missverständnis - misunderstanding
umsonst - for free
Pflicht sein - to be obligatory
unter Umständen - potentially
teuer - expensive
Geld verdienen - to earn money
die Rechnung - invoice
etw. verhindern - to avoid sth.
der Hinweis - hint
Schweden - Sweden
die Redewendung - expression
Alter Schwede! (ugs.) - Gosh! (colloq.)
ausverkauft - sold out
unwichtig - irrelevant
das Jahrhundert - century
der Krieg - war
das Heer - army
erfahren - experienced
jdn. anheuern - to engage sb.
der Ausbilder - instructor
hunderte Jahre alt - hundreds of years old
überwältigt - overwhelmed
nichts für etw. können - to not be responsible for sth.
vernünftig - reasonable
die Flüchtlingspolitik - refugee policy
sich verbreiten - to spread
mit etw. umgehen - to handle sth.
reduzieren - to reduce
die Meldung - the notification
etw. ausstellen - to turn sth. off
abstürzen - to crash 
mit etw. konfrontiert werden - to be confronted with sth.
das Ohnmachtsgefühl - feeling of powerlessness
für etw. plädieren - to argue for sth.
etw. beitragen - to contribute sth.
generell - in general
der nächste Schritt - next step
die schlechte Laune - bad mood
zu etw. beitragen - to contribute to sth.
jdn. persönlich betreffen - to concern sb. personally
das Handeln - action
mit etw. zu tun haben - to be related to sth.
ändern - to change
ansonsten - otherwise
sich verschlechtern - to get worse
informiert sein - to be informed
der Anstand - common decency
die Gesundheit - health
an erster Stelle - top priority
mit etw. übereinstimmen - to agree with sth.
von etw. erschlagen werden - to be devastated by sth.
das Lebensverhältnis - living situation
auf Kosten - at the cost of
die Waffe - weapon
jdn. ausbeuten - to exploit sb.
die Startbedingung - starting condition
der Boden - soil
fruchtbar - fertile
die Dürre - drought
die Überschwemmung - flooding
selbstverständlich - natural
der Punkt ist - the point is
jeden Morgen - every morning
wählen - to vote
in dem Sinne - in this sense
gefangen sein - to be trapped
sich zurück besinnen - to recollect
die Veränderung - change
der Bestandteil - ingredient
unterschreiben - to sign
die Geste - gesture
etw. bewirken - to effect sth.
im Alltag - in daily life
der Müll - trash
etw. aufheben - to pick sth. up
selbstverständlich - taken for granted 
die Achtsamkeit - awareness
der Augenblick - moment
etw. bestätigen - to confirm sth.
etw. leugnen - to deny sth.
der Wettbewerb - competition
die Auszeichnung - award
der Gewinner - winner
der Favorit - favorite
die Rhabarbermarmelade - rhubarb jam
zum Frühstück - for breakfast
das Dorf - village
die Gegend - region
der Stammkunde - regular customer
der Barbar - barbarian
und so weiter und so fort - and on and on
der Quatsch - nonsense
in etw. abgegleiten - to slide into sth.
das fünftschönste Wort - the fifth nicest word
Platz drei - rank three
jdn. lieben - to be in love with sb.
Geht so.  - Not really. 
die Geborgenheit - feeling of security
die Burg - castle
die Habseligkeiten - belongings
ideel - based on ideas
die Abwesenheit - absence
Auf jeden Fall! - Absolutely!
die Geschichte - story
Schieß los! (ugs.) - Go for it! (colloq.)
griechisch - greek
der Denker - thinker
ungenau - inaccurate
berechnen - to calculate
die Idee dahinter - the underlying idea
präzise - precise
sich für etw. entscheiden - to choose sth.
die wirkliche Welt - real life
der Schatten - shadow
unperfekt - imperfect
etw. begreifen - to understand sth.
etw. meinen - to mean sth.
erlauben - to make it possible
Griechenland - Greece
vierhundert vor Christus - four hundred before Christ
das Altertum - ancient times
die Antike - antiquity
die Geometrie - geometry
vordergründig - mainly
die Mathematik - mathematics
das Papier - paper
etw. aufschreiben - to write sth. down
kompliziert - complicated
Notizen machen - to take notes
der Stock - stick
der Boden - ground
das Dreieck - triangle
zeichnen - to draw
wackelig - shaky
die Realität - reality
die Zeichnung - drawing
die Welt der Ideen - the world of ideas
das Bild - image
nicken - to nod
das Gleichnis - allegory
der Höhle - cave
brennen - to burn
das Feuer - fire
die Wand - wall
die Übung - exercise
der Inhalt - content
der Anfänger - beginner
das Höhlengleichnis - allegory of the cave
stolz - proud
sich mit etw. auseinandersetzen - to deal with sth.
etw. anwenden - to apply sth.
einheitlich - uniform
die Neigung - tendency
aus etw. bestehen - to consist of sth.
messen - to measure
etw. anfassen - to touch sth.
das Gedachte - what is being thought
eine Rolle spielen - to play a role
der Aufbau - structure
etw. ausblenden - to suppress sth.
wunderschön - beautiful
machbar - doable
unmoralisch - unethical
das Unperfekte - the imperfect
etw. verändern - to change sth.
sich von etw. verabschieden - to say goodbye to sth.
in meiner Jugend - in my youth
kämpfen - to fight
gewinnen - to win
sich zurücklehnen - to lean back
etw. umsetzen - to implement sth.
etw. zum Fall bringen - to overthrow sth 
sein Leben in den Griff bekommen - to get one's life under control
Ende Gelände (ugs.) - it's over (colloq.)
etw. verpassen - to miss out on sth.
die Früchte der Arbeit - fruits of labor
etw. genießen - to enjoy sth.
unauffällig - without being noticed
einfallen - to remember
älter - older
die Karriere - career
etw. empfehlen - to recommend sth.
gleichzeitig - simultaneously
verkleidet - dressed up
ein Teil von - a part of
ostdeutsch - Eastern German
der Kleingärtner - garden plot holder
diskutieren - to discuss
das Wildschwein - wild boar
zerstören - to destroy
etw. leiten - to moderate sth.
unausstehlich - insufferable
verzweifeln - to despair
Vorrang haben - to have priority
Ihrer Ansicht nach - in your opinion
der Sparer - saver
der Gelackmeierte (ugs.) - betrayed person (colloq.)
natürlich - of course
etw. extra machen - to do sth. on purpose
der Scherz - joke
Ich find's köstlich! - I find it very funny!
unmöglich - impossible
erkennen - to recognize
sehr lang her - a long time ago
das Kleinbürgertum - petty bourgeoisie
etw. rauskehren - to bring out. sth.
der Alltag  - daily life 
auf's Korn nehmen (ugs.) - to satirize (colloq.)
verarschen (ugs.) - to mess with (colloq.)
der Schrebergarten - garden allotment
sich aufregen - to get excited
sich in Rage reden - to talk oneself into a rage
schuld sein - to be at fault
sich beschweren - to complain
witzig - funny
etw. auswählen - to choose sth.
zum Thema passen - to be relevant to the subject
Albanien - Albania
einsam - lonely
sich isolieren - to isolate oneself
es schwer haben - to have a hard time
sich sozialisieren - to socialize
die Einsamkeit - loneliness
die persönliche Entwicklung - personal development
aus dem Grund - for the reason that
mehrmals - several times
im Ausland leben - to live abroad
der Austauschschüler - exchange student
kennen lernen - to get to know
im Sinne von - in the sense of
traurig stimmen - to make sb. sad
wachsen - to grow
vermissen - to miss
alleine - alone
sich etw. vornehmen - to intend to do sth.
die Fahrradtour - bicycle tour
lächerlich - ridiculous
um die Welt reisen - to travel the world
das Problem anpacken - to tackle the problem
das Gegenteil - the opposite
der Fall sein - to be the case
der Gemeinschaftsraum - common room
der Ort - place
sich aufhalten - to stay
ins Gespräch kommen - to start a conversation
der Eingang - entrance
rauchen - to smoke
weinen - to cry
dazu gehören - to belong
sowohl … als auch - as well as 
der Tipp - piece of advice
bewusst - consciously
akzeptieren - to accept
in gewisser Weise - in some ways
andererseits - on the other hand
der Fehler - mistake
das Treffen - meeting
nervig - annoying
Freunde finden - to make friends
sich vorstellen - to introduce oneself
die Bühne - stage
angesprochen werden - to be approached
zusammenhängen - to be connected
schüchtern - shy
Grenzen überwinden - to overcome boundaries
auf einer Skala von eins bis zehn - on a scale of one to ten
elf - eleven
das Stichwort - keyword
mein Herz hüpft - my heart leaps
der Kommentar - comment
unter Umständen - maybe
irgendwann - someday
halte dich fest - hold on tight
die Bewertung - rating
die Zahl der Illuminati - number of the Illuminati
etw. da lassen - to leave sth.
hüpfen - to jump
höher - higher
der Traumjob - dream job
das Mischpult - mixing desk
etw. einspielen - to play sth.