mein Lieber - my dear fellow
der Freund - friend
an etw. liegen - to be due to sth.
leider - unfortunately
krank - ill
unbedingt - absolutely
jmd. anrufen - to call sb.
eigentlich - actually
den Umständen entsprechend - given the circumstances
Serien gucken - to watch TV shows
sich eine Pause nehmen - to take a break
etw. herausfinden - to find out about sth.
ehrlich gesagt - to be honest
es geht um etw.  - it's about sth. 
zumindest - at least 
Zeit haben - to have time
empfehlen - to recommend
die Augen zumachen - to close one's eyes
auf dem richtigen Weg sein - to be on the right track
in den letzten Jahren - in recent years
auf der Liste stehen - to be on the list
das Buch - book
weiter - further
Worum geht's? - What is it about?
die Zukunft - future
das Gegenteil - opposite
schlecht - bad
die Regierung - government
Rechte haben - to have rights
passieren - to happen
schlimm - terrible
traurig - sad
verlockend - tempting
der Kurzfilm - short film
der Naturfilm - nature film
ich muss sagen - I have to admit
die Tierwelt - wildlife
hell - bright
der Ablauf - process
fantastisch - fantastic
fit - fit
langsam - slow
die Vorschau - preview
langweilig - boring
Kaffee trinken - to have coffee
quatschen - to chat
anfangen - to start
Gute Besserung! - Get well soon!
zwischendurch - in between
der Skorpion - scorpion
am Start sein (ugs.) - here: to be part of (colloq.)
leuchten - to glow
unter Wasser - underwater
berichten - to report
etw. gerne machen - to be happy to do sth.
etw. nachholen - to catch up on sth.
sich näher unterhalten - to have a closer conversation
etw. planen - to plan sth.
Viel Spaß! - Have fun!
die Achtsamkeit - mindfulness
der Zweifel - doubt
überzeugt - convinced
meditieren - to meditate
regelmäßig - regularly
sich über etw. austauschen - to exchange about sth.
auf etw. zu sprechen kommen - to bring sth. up
der Hinweis - hint
etw. für sich machen - to do sth. for oneself
jmd. etw. aufdrängen - to impose sth. on sb.
in keiner Weise - not at all
grundsätzlich - in principle
seinen Weg finden - to find one's way
jmd. zustimmen - to agree with sb.
die Begeisterung - enthusiasm
überzeugen - to convince
unter dem Aspekt - considering that
der Zwiespalt - conflict
heilig sein - to be holy
die Esoterik - esotericism
das Zitat - quote
von etw. profitieren - to profit from sth.
in irgendeiner Weise - in one way or another
angeben - to show off
voraus sein - to be ahead
in Ordnung - alright
sich mit etw. beschäftigen - to occupy oneself with sth.
der Unterschied - difference
Was bedeutet das? - What does that mean?
etw. bemerken - to notice sth.
vorsichtig - carefully
der allererste Schritt - very first step
achtsam - mindful
etw. schulen - to train sth.
die Auswirkung - impact
der Schlüssel-Aspekt - key aspect
die Absicht - intention
der Lebensbereich - area of life
überhöht - overrated
die Vorstellung - idea
zauberhaft - magical
schweben - to float
die Übung - exercise
sich bewusst sein - to be aware
der Atem - breath
der Gedanke - thought
etw. gehen lassen - to let sth. go
abgelenkt - distracted
bekannt - well-known
wütend - furious
etw. schaffen - to manage to do sth.
fürchterlich - terrible
der Streit - dispute
etw. bereuen - to regret sth.
die Persönlichkeit - personality
religiös - religious
der Grund - reason
der Hintergrund - background
der Lehrer - teacher
erklären - to explain
mittlerweile - by now
etw. mögen - to like sth.
der Gründer - founder
verrückt - crazy
der Brite - Briton
der Sprecher - speaker
der Mönch - monk
die Stimme - voice
völlig losgelöst - entirely detached
die Glaubensrichtung - religious persuasion
offen - open
die Regel - rule
die Rahmenbedingung - general conditions
etw. gestalten - to shape sth.
die Hilfe - help
und so weiter und so fort - and on and on
etw. einordnen - to categorize sth.
die Bewertung - judgement
etw. anders machen - to do sth. differently
jmd. etw. in die Hand geben - to put sth. into sb.'s hands
schwierig - difficult
blind - blind
sich auf etw. einlassen - to be open to sth.
spätestens - at the latest
merken - to notice
das Gefühl - feeling
plötzlich - suddenly
die Erfahrung - experience
es bringt mir was - it's of use to me
etw. beschreiben - to describe sth.
das Vertrauen - trust
etw. dabei rausspringen (ugs.) - to get sth. out of it (colloq.)
unterstreichen - to underline
bewusst - aware
der Arbeitstag - working day
glücklich - happy
sauer - angry
die Möglichkeit - possibility
sich auf etw. besinnen - to refocus on sth.
ausgelutscht (ugs.) - worn out (colloq.)
nerven - to annoy
stärken - to strengthen
in der Lage sein - to be able to
rasen - to race
der Einfluss - impact
etw. erleben - to experience sth.
entscheiden - to decide
mit etw. umgehen - to handle sth.
einspringen - to step in
der Schiedsrichter - referee
was oft gesagt wird - what is often said
was das angeht - for that matter
reagieren - to react
der Wert - value
beruflich - professionally
im Gegenteil - on the contrary
Distanz einnehmen - to keep distance
etw. betrachten - to look at sth.
die Gelassenheit - calmness
in Anführungszeichen - in quotes
der Traum - dream
angeblich - supposedly
während man träumt - while dreaming
die Sache - thing
etw. genießen - to enjoy sth.
nichts zu verlieren - nothing to lose
sich die Frage stellen - to ask the question
konditionieren - to condition
wirklich - really
der Alltag - everyday life
irgendwie - somehow
einen Schritt zurück gehen - to take a step back
das Objekt - object
was ähnliches - something similar
der Satz - sentence
die U-Bahn - subway
der Vollzeit-Job - full-time job
die Lücke - gap
lesen - to read
laufen gehen - to go running
der Arbeitsweg - way to work
das Handynetz - mobile network
nutzen - to use
sich etw. angewöhnen - to get into the habit of sth.
etw. übernehmen - to adopt sth.
begeistert - enthusiastic
wild - wild
das Flugzeug - airplane
der Zug - train
nach Hause fahren - to drive home
die Ausrede - excuse
am Steuer - driving
die Anfälligkeit - susceptibility
das Störgeräusch - (disturbing) noise
bekämpfen - to fight
bewiesen - proven
das Hintergrundgeräusch - background noise
still - silent
der Ort - place
in etw. einbinden - to include in sth.
akzeptieren - to accept
die Überleitung - transition
die Entscheidung - decision
das Thema - subject
sich unterhalten - to talk
das ganze Leben - all life long
verboten - forbidden
etw. nutzen - to use sth.
sich gegen etw. entscheiden - to decide against sth.
mit etw. rechnen - to expect sth.
das Tempo rausnehmen - to slow down
Zeit verbringen - to spend time
unheimlich - incredibly
aus ganzem Herzen - with all one's heart
einfach - simple
abstrahieren - to abstract
kompliziert - complicated
für den Rest deines Lebens - for the rest of your life
verunsichern - to make insecure
die Nachricht - message
die Postkarte - postcard
klingeln - to ring
die Haustür - front door
unrealistisch - unrealistic
SMS - text message
klassisch - classic
etw. aushandeln - to negotiate sth.
die Entzugserscheinung - withdrawal symptom
halten wir fest - let's note
die Unterschrift - signature
der Vertrag - contract
das Gute - the good thing
hypothetisch - hypothetical
sich entscheiden - to decide
das Prinzip - principle
einfach anrufen - just call
stärker - stronger
der Komiker - comedian
sterben - to die
die Unterhaltung - conversation
bekannt - famous
zeichnen - to draw
der bekannteste - most famous
die Alltagssituation - everyday situation
auf den Arm nehmen (ugs.) - to pull sb.'s leg (colloq.)
die Beobachtungsgabe - skill of observation
witzig - funny
das Ehepaar - married couple
oberflächlich - superficially
sich selber erkennen - to self-recognize
Spaß machen - to be fun
einordnen - to classify
verschieden - various
der Bettenkauf - bed purchase
streiten - to argue
ruhen - to rest
das Eck (ugs.) - corner (colloq.)
kurz - short
der Ausdruck - expression
Ach was! (ugs.) - You don't say! (colloq.)
vorkommen - to appear
die Überraschung - surprise
inflationär - inflationary
überrascht - surprised
ungewöhnlich - unusual
definitiv - definitely
verzichten - to do without
stattdessen - instead
ironisch - ironic
der Tonfall - tone of voice
zusammenhängen - to be related
ausgeglichen - balanced
die Fassade - façade
das Streitgespräch - dispute
schreien - to scream
der Fahrradfahrer - cyclist
der Autofahrer - car driver
der Fußgänger - pedestrian
ruhig bleiben - to keep cool
es wert sein - to be worth it
der Straßenverkehr - traffic
gefährlich - dangerous
zum Schluss kommen - to conclude
etw. nicht fassen können - to be stunned by sth.
der Fahrer - driver
das nahende Auto - approaching car
der junge Herr - young gentleman
abrupt - abruptly
den Weg abschneiden - to cut the way off
der Schulterblick - shoulder view
das Fenster - window
als gäbe es kein Morgen - like there's no tomorrow
Glück haben - to be lucky
Es tut mir leid. - I am sorry.
die Absicht - purpose
ehrlich - seriously
verwirrt - confused
überlegen - to think
eine Entschuldigung annehmen - to accept an excuse
die Geschichte - story
die Straße - road
eng - narrow
der Bürgersteig - sidewalk
überholen - to overtake
die Faust - fist
die Geschwindigkeit - speed
anderthalb - one and a half
der Rennradfahrer - racing cyclist
die Ampel - traffic light
einen Ticken (ugs.) - a little (colloq.)
Wut im Bauch haben - to seethe with anger
schuldbewusst - guilt-ridden
jmd. einholen - to catch up with sb.
sich beruhigen - to calm down
sich versöhnen - to make it up 
aufrecht - honest
die Überzeugung - conviction
am Thron sägen (ugs.) - to saw from the throne (colloq.)
die Betrachtungsweise - point of view
etw. fortführen - to continue sth.
etw. zusammenfassen - to summarise sth.
im richtigen Moment - at the right moment
dazu gehören - to belong to 
weiter führen - to carry on
der öffentliche Nahverkehr - public transport
in der gesamten Stadt - across the city
kostenlos - for free
der Nahverkehr - public transport
fahrscheinfrei - without a ticket
herrlich - wonderful
der Autor - author
funktionieren - to work
zu Problemen führen - to cause trouble
das Klimaziel - climate goal
etw. verfehlen - to miss sth.
das Geld - money
benutzen - to use
bezahlen - to pay
die Steuer - tax
hoffentlich - hopefully
der Ausbau - expansion
teuer - expensive
zweifeln - to doubt
die Priorität - priority
die Gesellschaft - society
draufzahlen - to pay on top
die Kosten - costs
die Umweltbelastung - environmental damage
das Steuersystem - tax system
experimentieren - to experiment
vorbereiten - to prepare
der Zauberwürfel - Rubik's Cube
zaubern - to do magic
sich etw. vorstellen - to imagine sth.
schwer - difficult
die Nichte - niece
kürzlich - recently
etw. zeigen - to show sth.
schmuggeln - to smuggle
etw. vergessen - to forget sth.
die Kontrolle - control
schmeißen - to throw
der Metalldetektor - metal detector
die Pause - break
wichtig - important
natürliches Beispiel - natural example
spontan - spontaneously
konzentrieren - to concentrate
die Aufmerksamkeitsspanne - attention span
in die Luft gucken - to stare into space
der Kopf rattert (ugs.) - to think hard (colloq.)
ablenken - to distract
der Würfel - cube
die Millionenfrage - million dollar question
einzeln - individual
vier mal vier - four times four
die Seite - side
Du hast recht. - You're right.
ausrechnen - to calculate
sozusagen - so to speak
sich überschneiden - to overlap
über's Eck - round the corner
der Stein - piece
etw. abziehen - to subtract sth.
Ach du heilige Mutter! - Holy Mother!
witzigerweise - funnily enough
teilen - to share
sich ausleihen - to borrow
besuchen - to visit
das Gehirn - brain
lösen - to solve
die Ebene - level
kosten - to cost
der Algorithmus - algorithm
der Schritt - step
das Muster - pattern
anwenden - to apply
anstrengend - exhausting
die Tätigkeit - activity
die Aufmerksamkeit - attention
langfristig - long-term
verbinden - to connect
reinhören - to listen to
ein Leben lang - all one's life
sich etw. verschreiben - to dedicate oneself to sth.
ausprobieren - to try
der Frauenname - woman's name
Die unendliche Geschichte - The Neverending Story
berühmt - famous
das Kind - child
vorlesen - to read aloud
wunderschön - wonderful
das Kinderbuch - children's book
der Empfehlungsvorschlag - proposed recommendation
übernehmen - to take over
der Musiker - musician
studieren - to study
das Zweitinstrument - secondary instrument
die Klarinette - clarinet
die Querflöte - transverse flute
das Klavier - piano
das Saxofon - saxophone
der Beruf - profession
sich etw. annehmen - to adopt sth.
der Vorschlag - proposal
etw. ausfallen lassen - to skip sth.
sich verquatschen (ugs.) - to chat away (colloq.)
etw. vorschlagen - to propose sth.
dementsprechend - according to this
etw. in etw. einbinden - to integrate sth. into sth.
aus meiner Sicht - from my point of view
der Text - lyrics
die Härte - hardness
der Künstler - artist
der Bekanntheitsgrad - degree of popularity
der Rassismus - racism
aktuell - current
schwedisch - Swedish
aussprechen - to pronounce
bedeuten - to mean
absurd - absurd
der Höhepunkt - highlight
das Reiseland - country of destination
etw. verherrlichen - to glorify sth.
ständig - always
allerhand - all sorts of
etw. in den Himmel loben (ugs.) - to praise sth. to the skies (colloq.)
musikalisch - musically
spanisch - Spanish
zusammenpassen - to fit together
gelungen - successful
jmd. verehren - to worship sb.
die Klippe - cliff
aus der Nummer rauskommen (ugs.) - to get out of sth. (colloq.)
erfolgreich - successful
das Sprachspiel - linguistic play
der Deutschrap - German Rap
hinterher kommen - to catch up with
der Nummer-Eins-Hit - number-one hit
die Redewendung - expression
der Mensch - human being
politisch - political
ansonsten - otherwise
schöne Grüße - best regards
schicken - to send
du wirst es kaum glauben - you won't believe it
der Zufall - chance
tatsächlich - actually
die Sonne scheint - the sun is shining
aus Liebe - for love
die Bürokratie - bureaucracy
etw. loben - to praise sth.
das Papier - paper
lachen - to laugh
sich über etw. beklagen - to complain about sth.
ein Kind zur Welt bringen - to give birth to a child
Herzlichen Glückwunsch! - Congratulations!
einen Brief senden - to send a letter
unterschreiben - to sign
im Hinterkopf - in the back of mind
das Elterngeld - parental allowance
die Beantragung - application
der Amts-Gang - official government transactions
erwarten - to expect
niedrig - low
der Anspruch - standard
Lateinamerika - Latin America
die Bestechlichkeit - corruption
der Ärger - trouble
lange dauern - to take long
viele Nerven kosten - to be stressful
etw. ausfüllen - to fill sth. in
zweifellos - without a doubt
etw. verfluchen - to curse sth.
wahrscheinlich - probably
gleiches Recht für alle - equal rights for all
der Begriff - term
die Steuererklärung - tax declaration
hilfreich - helpful
etw. erreichen - to achieve sth.
verstehen - to understand
vollständig - completely
von Menschen erschaffen - created by humans
einer Meinung sein - to agree
aus Versehen - unintentionally
das Auto - car
der Parkplatz - parking lot
die Polizeiwache - police station
in Eile sein  - to be in a rush 
das Knöllchen (ugs.) - parking ticket (colloq.)
geliehen - borrowed
unangenehm - uncomfortable
die Strafe - penalty
die Antwort vorwegnehmen - to anticipate the answer
überweisen - to transfer
Geld annehmen - to accept cash
einen Brief zustellen - to deliver a letter
der Gebührenbescheid - notice of the fee
in anderen Ländern - in other countries
auf die Kralle (ugs.) - cash in hand (colloq.)
es hat seine guten Seiten - it has its good sides
Ägypten - Egypt
die Sorge - concern
der Fehler - mistake
peinlich - embarrassing
sich duzen - to be on first name terms
sich siezen - to use the polite form
das Ausland - abroad
aufladen - to recharge
das Gespräch - conversation
die Währung - currency
sich erinnern - to remember
fünfzig - fifty
umgangssprachlich - colloquial
flapsig - offhand
ermutigen - to encourage
die Vergangenheit - past
etw. aufhalten - to hold sth. up
zu etw. raten - to advise sth.
beschäftigen - to deal with
die Empfehlung - recommendation
eine lange Zeit - for a long time
das Tagebuch - diary
jmd. auf etw. hinweisen - to make sb. aware of sth.
Briefe austauschen - to exchange letters
korrigieren - to correct
richtig heißen - to be called correctly
mehrmals - several times
etw. loswerden - to get rid of sth.
anders - differently
versuchen - to try
sich etw. bewusst machen - to become aware of sth.
Da schließt sich der Kreis. - And so we've come full circle.
folgen - to follow
das Bild - image
künstlerisch - artistic
widersprechen - to contradict
versprechen - to promise
seiner Begeisterung Ausdruck geben - to express one's enthusiasm
die Leidenschaft - passion
das Netzwerk - network
der Nachmittag - afternoon
kritisch - critical
löschen - to delete
halbe Sachen machen - to do sth. by halves
der Vorteil - advantage
weltweit - worldwide
selbstverständlich - of course
in Kontakt bleiben - to stay in contact
die Firma - company
dafür sorgen - to make sure
der Witz - joke
die Benachrichtigung - notification
was … betrifft - with relation to ...
jmd. erreichen - to reach sb.
anschauen - to take a look at
so nach dem Motto (ugs.) - as if to say (colloq.)
die Brücke - bridge
ausschalten - to switch off
der Bildschirm - screen
der Modus - mode
sicherlich - certainly
etw. ausstellen - to turn sth. off
sparsam - economical
zur gegebenen Zeit - at the appropriate time
ich bin voll bei dir - I totally agree with you
abbestellen - to unsubscribe
einsortieren - to sort
der Ordner - folder
sich etw. durchlesen - to read through sth.
ankommen - to arrive
unterbrechen - to interrupt
etw. senden - to broadcast sth.
am gleichen Tag - on the same day
Lust haben - to be in the mood
die Einladung - invitation
Bis bald! - See you soon!