gut gelaunt - in a good mood
aufzeichnen - to record
in der Regel - usually
der Zuschauer - the viewer
schwierig - difficult
Vokabelhilfe - vocabulary helper
schneiden - to edit
eigentlich - actually
nur ganz leicht - just very slightly
wahnsinnig - insanely
der Spaß - the fun
die Nachricht - the message
anfangen - to start
sich freuen - to be delighted
irgendwann - someday
noch länger - even longer
schaffen - to manage
genau richtig - just right
Bock haben (ugs) - to want (colloq)
besprechen - to discuss
zu kurz - too short
statt - instead of
erstmal - for now
drücken - to press
erlaubt sein - to be allowed
sich aufsparen - to save up
an einem Stück - in one go
die Pflicht - the obligation
einsteigen - to get in
die Anmerkung - the note
der Klimawandel - climate change
sonntags geschlossen - closed on Sundays
der Ärger - the anger
das Fahrradgeschäft - the bicycle shop
das Wochenende - the weekend
die Angelegenheit - the matter
die Hochzeit - to wedding
das Ergebnis - the result
sich aufs Glatteis begeben (ugs) - to be on a slippery slope (colloq)
die Einzelhandelskette - the retail chain
die Kindheit - the childhood
unvorstellbar - unimaginable
aufregen - to get mad
die Möglichkeit - the possibility
heilig - sacred
der Feiertag - to holiday
feiern - to celebrate
traurig - sad
zum ersten Mal - for the first time
Weihnachten - Christmas
im Prinzip - basically
strömen - to pour
das Angebot - the offer
die Vorstellung - the idea
der Familienfeiertag - the family holiday
verrückt - insane
jmd. Recht geben - agree with sb.
der Kleiderladen - the clothes shop
so bleiben - to stay that way
die Firma - the company
die Kette - the chain
die Leidenschaft - the passion
in der Regel - generally
der Mitarbeiter - the employee
gerade deswegen - precisely because of this
geschlossen - closed
auf etw. achten - to look out for sth.
schaden - to harm
pleite gehen - to go bankrupt
das Gesetz - the law
der Ladenbetreiber - the shopkeeper
ruinieren - to ruin
die Kneipe - the pub
rauchen - to smoke
das Recht - the right
die Freiheit - freedom
schrecklich - terrible
vernünftig - reasonably
abwägen - to weigh
auf Krawall gebürstet sein (ugs) - to be ready for a riot (colloq)
der Späti (Berlin) - the kiosk (Berlin)
keine Ahnung - no idea
hilfreich - helpful
das Wörterbuch - the dictionary
der Skandal - the scandal
vorkommen - to occur
bedeuten - to mean
kämpfen - to fight
der Konflikt - the conflict
in Kauf nehmen - to tolerate
der Krawall - the riot
der Krach - the ruckus
streiten - to argue
das Sprichwort - the proverb
der Widerstand - the resistance
die Einstellung - the attitude
bürsten - to brush
widerspenstig - stubborn
auf jeden Fall - in any case
schicken - to send
die Ordnung - the order
aufgeregt sein - to be excited
berühmt - famous
zutreffen - to hold true
ordnungsliebend - orderly
feststellen - to determine
das Bild - the image
der Sinn - the sense
spannend - fascinating
im Ausland - abroad
wahrnehmen - to perceive
sich lustig machen - to make fun of
die Augen verdrehen - to roll one's eyes
furchtbar - terrible
bewundern - to admire
mal so und mal so - both ways
nerven - to annoy
zu jeder Zeit - at all times
im Falle - in the event
der Tod - death
erzählen - to tell
stolz - proudly
wichtig - important
witzig - funny
der Einfluss - the influence
die Ordnungsliebe - the love of order
der Aspekt - the aspect
erfüllen - to fulfill
glücklich - happy
sortiert - sorted
in Ordnung - in order
auf etw. zu sprechen kommen - to talk about sth.
erfinden - to invent
die Römer - the Romans
die Horden - the hordes
Ordnung ist das halbe Leben - organization is half the battle
der Volksmund - the common parlance
die Frage - the question
das Lieblingsland - the favorite country
der Urlaub - to holiday
unorganisiert - disorganized
der Straßenverkehr - to road traffic
verunglimpfen - to disparage
überzeugen - to win over
treu - faithfully
adaptieren - to adapt
anscheinend - apparently
in Ordnung sein - to be all right
sich auf jmd. verlassen - to rely on sb.
der Mülleimer - the trash can
das Wortspiel - the pun
benutzen - to use
der Begriff - the term
das Lachen - the laughter
das Ordnungsamt - the regulatory office
die Befugnis - the power
die Vorschrift - the regulation
grillen - to have a barbecue
für etw. sorgen - to ensure sth.
abgestuft - tiered
das Verbrechen - the crime
zuständig - responsible
herrschen - to prevail
ein Gesetz brechen - to break a law
die Ampel - the traffic light
parken - to park
schaden - to do harm
die Straftat - the criminal offense
die Ordnungswidrigkeit - the misdemeanour
das Bußgeld - the fine
der Bescheid - the notice
über Rot fahren - to run a red light
der Fußgänger - the pedestrian
der Anwalt - the lawyer
der Richter - the judge
der Bußgeldkatalog - the catalogue of fines
jmd. gefährden - to endanger sb.
der Sachschaden - to property damage
der Unterschied - the difference
unbedingt - absolutely
die Angst - the fear
mit etw. zu tun haben - to be related to sth.
der Gedanke - the thought
sozusagen - so to speak
festgehalten - captured
beruhigt - reassured
das Gefühl - the feeling
die Unterlage - the document
der Brief - the letter
einsortieren - to sort
etw. Wichtiges - sth. important
auf Papier - on paper
das Zeugnis - the certificate
wegschmeißen - to ditch
als nächstes - next
landen - to land
der Ordner - the folder
rein kommen - to go in
anfallen - to accrue
sortieren - to sort
im Alltag - in everyday life
beschäftigen - to preoccupy
ankommen - to arrive
der Schreibtisch - the desk
verreisen - to travel
aufmachen - to open
merken - to notice
jmd. verrückt machen - to drive sb. crazy
mächtig - powerful
im Sinne von - in the sense of
alltäglich - everyday
die Einkaufsliste - the shopping list
das Ziel - the goal
erreichen - to achieve
irgendwann - at some point
abhaken - to check off
allumfassend - all-encompassing
hinzufügen - to add
erinnert werden - to be reminded
die Sorge - the worry
vergessen - to forget
ähnlich - similar
der Ordnungssinn - the sense of order
das Schlimmste - the worst
nervig - annoying
aufschreiben - to write down
durchstreichen - to cross out
erledigen - to complete
übertragen - to transfer
der Überblick - the overview
entspannt - relaxed
überfordern - to overwhelm
auf einen Schlag - in one fell swoop
der Endorphin-Kick - the rush of endorphins
etw. schaffen - to manage sth.
die Aufgabe - the task
etw. erledigen - to get sth. done
ungefähr - approximately
verschieben - to defer
weiter arbeiten - to continue working
klappen - to work out
die Steuer - the tax
einreichen - to submit
veröffentlichen - to publish
die Sprache - the language
in Zukunft - in the future
angehen - to tackle
ausblenden - to hide
transzendentale Meditation - transcendental meditation
das Schlagzeug - the drums
der Unterricht - the lessons
der Jugendliche - the teenager
der Traum - the dream
verwirklichen - to realize
das Vergessen - the forgetting
etw. angehen - to tackle sth.
geheim - secret
mehrere - several
genug - enough
harmlos - innocuous
die Werbung - the advertisement
die Ausstellung - the exhibition
stressen - to stress
der Hauptgrund - the main reason
anlegen - to create
ausprobieren - to try
Sinn machen - to make sense
auffallen - to notice
die Empfehlung - the recommendation
die Serie - the series
wandern - to move
die Notiz - the note
anstreichen - to mark
das Tagebuch - the diary
der Alltag - to everyday life
schriftlich - in writing
verarbeiten - to process
der Vortag - the previous day
die Befreiung - the release
der Zwang - the obligation
umsetzen - to realize
auf keinen Fall - by no means
sterben - to die
abarbeiten - to work through
andersrum - the other way around
der Besuch - the visit
überlegen - to ponder
aussuchen - to choose
der Alltag - everyday life
nicht stimmen - to not be true
durch den Kakao ziehen (ugs) - to make fun of (colloq)
ansprechen - to mention
seltsam - oddly
das Tabuthema - the taboo subject
die Gesellschaft - society
so tun als ob - to pretend as if
der Quatsch - the nonsense
das Wissen - the knowledge
passieren - to happen
das Jetzt - the present
aktuell - current
genießen - to enjoy
vorbereiten - to prepare
die Entscheidung - the decision
die sterblichen Überreste - the mortal remains
der Wille - the will
sicherstellen - to ensure
das Gerät - the device
abgesichert - safeguarded
der Zugriff - the access
verschlüsselt - encrypted
sinnvoll - reasonable
ausdenken - to think up
jmd. etw. zustoßen - to happen to sb.
mit etw. rechnen - to anticipate sth.
sich anmaßen - to presume
das Flugzeug - the plane
durchstarten - to bounce
die Untergangsszenarien - the doomsday scenarios
nachdenken - to ponder
die Umgebung - the surroundings
der Zugang - the access
etw. geschaffen haben - to have created sth.
entscheiden - to decide
möglich - possible
gesichert - safeguarded
beruhigen - to reassure
überleben - to survive
der Punkt sein (ugs) - to be the point (colloq)
die Nächstenliebe - the altruism
darum gehen - to be about
sich kümmern - to care for
aufsetzen - to set up
abgleiten - to drift
sich befassen - to deal with
vergeuden - to waste
die Studie - the study
etw. bereuen - to regret sth.
im Sterben liegen - to be dying
gefangen sein - to be trapped
glauben - to believe
kaufen - to buy
beruhigen - to pacify
die Ordnung - to order
sicher sein - to be sure
die Sorgen - the worries
umkippen - to collapse
Bescheid wissen - to be in the know
bereuen - to have regrets
Zeit verbringen - to spend time
wertschätzen - to appreciate
etw. bedeuten - to mean sth.
abgefrühstückt (ugs) - to be done with (colloq)
abarbeiten - to work off
bearbeiten - to finish
auf etw. bedacht sein - to be vigilant about sth.
sich um etw. kümmern - to take care of sth.
erfahren - to learn
die Wohnung - the apartment
die Wahl - the choice
es herrscht Chaos - there is chaos
aufräumen - to declutter
unmöglich - impossible
sauber - clean
eklig - disgusting
unaufgeräumt - untidy
völlig - utter
schrecklich - horrible
der Messie - the compulsive hoarder
die Eltern - the parents
picobello (ugs) - spotless (colloq)
der Boden - the floor
sauber - cleanly
der Müll - the garbage
sammeln - to collect
die Baustelle - the construction site
der Einkaufswagen - the shopping cart
das Zimmer - the room
die Klamotten - the clothes
finden - to find
anziehen - to put on
abschneiden - to cut off
der Becher - the cup
das Regal - the shelf
das Gegenteil - the opposite
gleichzeitig - at the same time
geordnet - neatly
das Büro - the office
zulegen - to get
geht das - is that possible
verbringen - to spend
zugreifen - to access
unglücklich - unhappy
grün - green
der Bereich - the area
in Ordnung - all right
schief gehen - to go wrong
nachgucken - to check
herkommen - to come from
die Straßenverkehrsordnung - the traffic regulations
das Farbsignal - the color signal
das Kontrollgerät - the control device
gelb - yellow
die Aufnahme - the recording
übersteuert - overdriven
gut gelaufen - gone well
raten - to guess
die Unordnung - the disorder
dafür sorgen - to make sure
stattfinden - to occur
zu tun haben mit - to have to do with
zu weit treiben - to go too far
die Regelhörigkeit - the unconditional observance of rules
einhalten - to abide
die Geschichte - the story
zusammenfassen - to summarize
der Zug - the train
falsch - wrong
die Dritt-Firma - the third-party company
das Lager - the warehouse
scheinbar - seemingly
der Schaffner - the conductor
rufen - to call
bemüht sein - to make an effort
herauskommen - to come out
die Richtung - the direction
durchlesen - to read through
die Wendung - the twist
einmischen - to interfere
das Hemd - the shirt
das Schwarzfahren - the fare evasion
mitnehmen - to take away
Quatsch sein - to be unnecessary (colloq)
abführen - to lead away
sich verwandeln - to turn into
erleichtert - unburdened
versprechen - to promise
der Ärger - the trouble
sich beteiligen - to pitch in
das Porte­mon­naie - the wallet
zumindest - at least
nerven - to bug
überhaupt - at all
hilflos - helpless
schwarz fahren - to evade the fare
bescheißen - to cheat
die Hilfe - the help
geschenkt - given for free
verlassen - to vacate
die Verständigungsschwierigkeit - the difficulty of communication
aufstehen - to get up
verständlich - understandable
sich weigern - to refuse
der Fall - the case
menschlich - humane
beharren - to persist
lösen - to solve
beurteilen - to assess
behaupten - to claim
verstehen - to understand
die Regel - the rule
anwenden - to apply
die Menschlichkeit - the humanity
auf der Strecke bleiben - to fall by the wayside
übertreiben - to overdo
die Behörde - the authority
die Kulanz - the gesture of goodwill
der Spielraum - the margin
in diesem Fall  - in this case 
ausgeprägt - pronounced
der Ausländer - the foreigner
verwirrend - puzzling
in manchen - in some
abstempeln - to stamp
aussehen wie - to look like
der Türsteher - the bouncer
fertig machen - to lambast
durchsetzen - to enforce
die Lösung - the solution
befähigen - to empower
im Rahmen - within the scope
der Maßstab - the standard
der Kunde - the customer
das Ansehen - the reputation
institutionell - institutionally
verankern - to embed
das Regelwerk - the set of rules
der Betrag - the amount
eine Regel brechen - to break a rule
die Ausnahme - the exception
der Chef - the boss
das oberste Gebot - the first priority
die Freundlichkeit - the friendliness
das Wichtigste - the most important thing
anders laufen - to be different
ermächtigen - to empower
streiten - to quarrel
lesen - to read
das Handy - the cell phone
gültig - valid
der Charakter - the personality
die Rolle - the role
bitten - to ask for
angenehm - enjoyable
anbetteln - to beg
tierisch (ugs) - extremely (colloq)
die Lieblingskategorie - the favorite category
sowas von (ugs) - extremely (colloq)
erwähnen - to mention
der Inhalt - the content
die Routine - the routine
empfinden - to experience
selbstbestimmt - self-determined
der Arbeitgeber - the employer
der Termin - the appointment
der Stützpfeiler - the supporting pillars
selbstständig - self-employed
arbeiten - to work
der Fall sein - to be the case
ausprobieren - to test out
die Freiheit - the freedom
der Vorteil - the advantage
der Arbeitsplatz - the workplace
sich bewegen - to move
sich aneignen - to adopt
morgendlich - morning
ausprobieren - to try out
die stärkste - the strongest
zur gleichen Zeit - at the same time
der Schlafrhythmus - the sleep rhythm
dringend - urgent
resultieren - to result
beantworten - to answer
das Mitglied - the member
jeden Morgen - every morning
duschen - to take a shower
frühstücken - to have breakfast
das Gleiche - the same thing
der Beitrag - the report
begleiten - to accompany
die Nachrichten - the news
witzig - humorously
vorgetragen - presented
der Nachmittag - the afternoon
angesagt sein - to be called for
regeln - to settle
treffen - to meet
meiner Wahl - of my choice
soziale Verpflichtungen - social obligations
nicht gut tun - to do no good
zur Ruhe kommen - to relax
beziehungsweise - or rather
der Rechner - the computer
langweilig - boring
nebenbei - on the side
klingen - to sound
spannend - thrilling
das Zitat - the quote
passen - to fit
im Gegensatz - in contrast
das Vorwort - the preface
schaffen - to accomplish
wahrscheinlich - probably
das Zeichen - the sign
bewusst - consciously
erarbeiten - to acquire
der Schriftsteller - the writer
die Geschichte - history
erfolgreich - successful
penibel - meticulous
der Beruf - the profession
sich selber nehmen - to take away from yourself
minutengenau - to the minute
um Punkt acht - at eight precisely
verabredet sein - to have a meeting
und zwar - namely
das Aufstehen - getting up
das allererste - the very first
hinkriegen - to manage
ablenken - to distract
der Wecker - the alarm clock
der Kopf - the head
das Schreiben - the writing
rumschwirren - to buzz around
das Blatt - the sheet
im Laufe des Tages - throughout the day
das Geheimnis - the secret
joggen - to go jogging
trotzdem - despite
die Minimal-Hürde - the minimal threshold
der Satz - the sentence
die Liegestütze - the push-up
der Erfolg - the success
das Sprachenlernen - the language learning
das Tagebuch - the journal
der Schalter - the switch
umlegen - to flip
das Gehirn - the brain
im Nachhinein - retrospectively
gut klingen - to sound good
das Computerspiel - the computer game
die Karte - the map
die Zivilisation - the civilization
die Schwierigkeitsstufe - the difficulty level
das Witzige - the funny thing
die Anmerkung - the comment
der Zeitraum - the period
dämlich - goofy
vermischen - to mix
deprimiert - depressed
beschreiben - to describe
nachvollziehen - to reconstruct
entwickeln - to evolve
die Tätigkeit - the activity
sich anschließen - to connect
etw. besprechen - to discuss sth.
bestimmte - certain
sich etw. vorsetzen - to make a resolution
im Grunde - in essence
tatsächlich - actually
sowas ähnliches - something similar
der Punkt - the point
meditieren - to meditate
die Zahl - the number
aufrecht erhalten - to uphold
das Glücksgefühl - the feeling of happiness
etw. geschafft haben - to have accomplished sth.
empfehlen - to recommend
im Rahmen - in the context of
Sprachen lernen - language learning
die Übung - the exercise
abnehmen - to reduce weight
die Bewegung - the movement
auf etw. achten - to pay attention to sth.
das Stockwerk - the floor
das Treppensteigen - the climbing of stairs
weiterführen - to carry on
spazieren - to walk
dauerhaft - permanently
funktionieren - to work
ausnahmsweise - for once
sich vorstellen - to imagine
kennenlernen - to get to know
die Nachrichtensendung - the news broadcast
der öffentlich-rechtliche Sender - the public service broadcaster
die Abgabe - the fee
öffentlich - public
das Fernsehen - to television
der Rundfunk - the broadcasting
unabhängig - independent
der Staat - the State
die Werbung - to advertising
getrennt - separately
vergleichbar - comparable
das Land - the country
die Sendung - the broadcast
der Anspruch - the aspiration
berichten - to report
gehören - to belong
niemandem - nobody
staatlich - state-run
geregelt - regulated
der Vergleich - the comparison
öffentliche Gelder - public funds
finanziert - financed
in die Richtung - in the direction
tatsächlich - in point of fact
auf etw. rumhacken - to pick on sth.
das Nachrichtensystem - the news system
vergleichen - to compare
die Werbung - the advertising
sich finanzieren - to fund oneself
beruhigt - steadied
sachlich - factually
künstlich - artificially
verzerren - to distort
der Nachrichtensender - the news channel
konkurrieren - to compete
der Sensationsgehalt - the amount of sensation
einschalten - to turn on
etw. schätzen - to value sth.
die Uhrzeit - the time
die Hauptsendung - the main program
mitlesen - to read along
anderthalb - one and a half
auswählen - to pick
die Textzeile - the text line
auf etw. stehen - to be into sth.
die Sauberkeit - to cleanliness
ursprünglich - originally
missverstehen - to misunderstand
triefen vor - to be oozing with
beschreiben - to characterize
auf den ersten Blick - at first sight
wörtlich - literal
die Wirklichkeit - the reality
die Kritik - the criticism
die Allerbesten - the very best
die Steuern - the taxes
der Weltrekord - the world record
das Volk - the people
zwischen den Zeilen - between the lines
die Liebeserklärung - the declaration of love
kontrovers - controversial
die Zustandsbeschreibung - the status description
der Heimatsland - the home country
die Meinung - the opinion
der Zeigefinger - the index finger
die Moralkeule (ugs) - being preachy (colloq)
die Verherrlichung - the glorification
die Verblödung - the stupidity
sich streiten - to argue
das Denkvermögen - the ability to think
ausgedrückt - phrased
die Selbstkritik - the self-criticism
einseitig - one-sided
andererseits - on the other hand
stolz - proud
Gott - God
die Erde - the earth
küssen - to kiss
die Stelle - the spot
ironisch - sarcastic
die Oper - the opera house
musikalisch - musically
die Datei - the file
hochladen - to upload
die Stimme - the voice
abspielen - to play back
am liebsten sein - to prefer
etw. hinkriegen - to manage sth.
schwer - difficult
der Kumpel (ugs) - the buddy (colloq)
der Bergbau - mining
der Untertagebau - the underground mining
das Abbauen - the removal
beschäftigt sein - to be employed
die Unternehmung - the activity
zuverlässig - trustworthy
umgekehrt - the other way around
der Freund - the friend
der Kumpel - the buddy
der Hauptbegriff - the main term
männlich - masculine
weiblich - feminine
das Geschlecht - the gender
ungerecht - unfair
eng - close
der Arbeitskollege - the co-worker
von etw. abraten - to advise against sth.
sich sicher sein - to be sure
das Fettnäpfchen (ugs) - to put one's foot in it (colloq)
aufs Glatteis führen (ugs) - to trip up sb. (colloq)
der Scherz - the joke
weiter machen - carry on
kostenlos - free
die Vokabelhilfe - the vocabulary helper
verfügbar - available
unterstützen - to support
es wert sein - to be worth it
leisten können - to be able to do
die Arbeit - the work
die Untertitel - the subtitles
möglich machen - to make possible
weder … noch - neither ... nor
regelmäßig - regularly
Vollzeit - full time
beschäftigt sein - to be busy
aufbauen - to build
verstärken - to augment
sich leisten können - to be able to afford
die Unterstützung - the support
zum Dank - in gratitude
sich bedanken - to thank
die ersten - the first
sich anmelden - to sign up
einige - a few
die Leute - the people