die Woche - the week
die Frage - the question
der Fehler - the mistake
sich erinnern - to remember
das Beispiel - the example
die Nachricht - the message
bekommen - to receive
vorspielen - to play
kommen aus - to come from
anhören - to listen to
empfinden - to perceive
jmd. einfallen - to occur to sb.
der Komparativ - the comparative
schneller - faster
eigentlich - really
erzählen - to tell
der Vergleich - the comparison
verwenden - to use
stimmen - to be true
auffallen - to catch sb.'s eye
betrunken - drunk
das Leben - the life
die Nacht - the night
vergessen - to forget
die Kneipe - the pub
bleiben - to stay
darstellen - to depict
die Regel - the rule
vermischen - to mix
unterschiedlich - different
im Prinzip - basically
falsch - wrong
im Alltag - in everyday life
furchtbar - terrible
anpassen - to adapt
die Meinung - the opinion
irgendwann - someday
hinterherhinken - to lag behind
die Übersetzung - the translation
der Sinn - the sense
die Redewendung - the idiom
mittlerweile - by now
sozusagen - so to speak
richtig - correct
geschenkt (ugs.) - fine (colloq.)
annähernd - anywhere close to
jmd. schlagen - to smack sb.
ausdrücken - to express
verneinen - to negate
abkürzen - to abbreviate
zusammenziehen - to merge
sich sicher sein - to be sure
dauerhaft - permanently
verwechseln - to mix up
etw. zulassen - to permit sth.
jmd. korrigieren - to correct sb.
realitätsfremd - out of touch with reality
das Porte­mon­naie - the wallet
einführen - to implement
fließend - fluid
jmd. zustimmen - to agree with sb.
überhaupt nicht - not at all
sich streiten - to argue
etw. gutheißen - to endorse sth.
sich etw. verschließen - to ignore sth.
verändern - to change
etw. besser machen - to improve sth.
ist ja egal - it doesn't matter
zufällig - by accident
leider - unfortunately
auf etw. zurückkommen - to come back to sth.
die Post - the mail
der Brief - the letter
die Postkarte - the postcard
feiern - to celebrate
der Geburtstag - the birthday
ehrlich gesagt - to be honest
im Urlaub - on vacation
sich verpflichtet fühlen - to feel obliged
Lust haben - to feel like it
der Ort - the place
die Ansicht - the view
befreundet sein - to be friends
die Tante - the aunt
das Patenkind - the godchild
der Aufruf - the request
längst nicht alle - nowhere near all
das Verzeichnis - the directory
gefunden werden - to be found
die Bewertung - the rating
der Kommentar - the comment
der Hörer - the listener
jmd. bitten - to ask sb.
hinterlassen - to leave
bekannter - better known
möchten - to would like
sich einig sein - to be in agreement
leicht - easy
lustig - fun
jmd. am Herzen liegen - to be dear to sb.'s heart
quatschen - to chat
die Raucherkneipe - the smoking bar
beschädigt sein - to be damaged
grölen - to holler
singen - to sing
das Lied - the song
sich trauen - to have the courage
die Dusche - the shower
versuchen - to try
sich etw. beibringen - to teach oneself sth.
musikalisch unterwegs sein (ugs.) - to be musically active (colloq.)
aus vollster Inbrunst - passionately
mitsingen - to sing along
schade - too bad
die Stimme - the voice
besitzen - to have
der Leihwagen - the rental car
peinlich - embarrassing
auf dem Land - in the countryside
joggen - to go running
das Feld - the field
niemand - nobody
die Richtung - the direction
anfangen - to start
der Atem - the breath
kontraproduktiv - counterproductive
die Hände über dem Kopf zusammenschlagen - to throw one's hands up in horror
herausfinden - to find out
das Bild - the image
der Kopf - the head
unbedingt - absolutely
das Tier - the animal
drumherum - around
weit und breit - far and wide
flüchten - to flee
das Klavier - the piano
vorhanden sein - to be there
der Haushalt - the household
von heute auf morgen - overnight
etw. aufbauen - to build up sth.
lernen - to learn
Spaß machen - to be fun
aus dem Gedächtnis - from memory
die Hände - the hands
wehtun - to hurt
die Hornhaut - the hard skin
die Küche - the kitchen
der Ständer - the stand
lächerlich - ridiculous
die Straße - the street
angeschlossen sein - to be connected
warten - to wait
kochen - to cook
die Kenntnisse - the knowledge
etw. hinbekommen - to manage sth.
funktionieren - to work
klingen - sound
entwickeln - to develop
die Ausdauer - the endurance
der Klavierunterricht - the piano lessons
heraussuchen - to find
glücklich - happy
geil (ugs.) - awesome (colloq.)
der Akkord - the chord
die Abfolge - the sequence
die Lieblingsband - the favorite band
stark ausgeprägt - very pronounced
verfolgen - to track
herausbringen - to bring out
auffallen - to notice
westlich - western
das Musikspektrum - the musical spectrum
dominierend sein - to dominate
Großbritannien - Great Britain
über etw. nachdenken - to ponder sth.
wie kommt das - how come
hervorbringen - to produce
das Gefühl - the feeling
die Erziehung - the education
künstlerisch - artistic
fördern - to foster
der Bereich - the area
die Kunst - the arts
die Gesellschaft - society
verankert sein - to be rooted
das Kulturgut - the cultural heritage
geschätzt werden - to be valued
brandaktuell - brand-new
generationsverbindend - generationally bonding
großartig - marvelous
die soziale Schicht - the social class
gemischt - mixed
sich begegnen - to come together
gemeinsam - jointly
der Durchschnittsdeutsche - the average German
die Volksmusik - the folk music
der Scheiß-Song - the shitty song
übergenerationell - trans-generational
idealisieren - to idealize
etw. gut treffen - to characterize sth. well
unglaublich - unbelievable
die Kraft - the force
was etw. betrifft - with regard to sth.
produzieren - to produce
erreichen - to achieve
in den seltensten Fällen - rarely ever
der Kultstatus - the cult status
die letzte - the last
sich trennen - to separate
vorletzte Woche - the week before last
die Schwester - the sister
etw. macht Spaß - sth. is fun
das beste - the best
vorab - in advance
schicken - to send
die Antwort - the answer
nachdenken - to ponder
einfallen - to occur to
wie gesagt - like I said
die Schulzeit - the school years
der Radiosender - the radio station
veranstalten - to organize
reinpassen - to fit
die Hälfte - half
gewinnen - to win
kaufen - to buy
verkaufen - to sell
der Termin - the date
zwölf Uhr mittags - twelve noon
zwölf Uhr nachts - twelve o'clock at night
Mitternacht - midnight
die Schlange - the queue
musizieren - to make music
sich anstellen - to queue
einmal um den Block - around the block
im Verkauf - on sale
hoffen - to hope
reichen - to suffice
der Personalausweis - the identity card
keinen Bock haben (ugs.) - to not be in the mood (colloq.)
die Bühne - the stage
kacke sein (ugs.) - to suck (colloq.)
erleben - to experience
abgesagen - to cancel
der Auftritt - the performance
sich streiten - to fight
mega geil (ugs.) - really awesome (colloq.)
die Zugabe - the encore
gut drauf sein - to be in a good mood
der Saal - the hall
mit Abstand - by far
der Kulturkreis - the culture
hauptsächlich - mainly
sich freuen - to be excited
verstehen - to understand
sich durchlesen - to read over
überlegen - to consider
der Musikunterricht - the music lessons
der Instrument-Unterricht - the instrument lessons
die Musikkultur - the musical culture
anlegen - to create
schwach - weak
mit etw. zu tun haben - to have to do with sth.
jmd. ermutigen - to encourage sb.
tanzen - to dance
sich vorstellen - to imagine
die Stimmung - the mood
in der Mitte - in the center
am Rand - at the edge
die Hüfte - the hip
pauschalisieren - to generalize
stärker - stronger
ausgeprägt sein - to be prevalent
eine Rolle spielen - to play a role
die Grundschule - the primary school
der Kindergarten - the pre-school
jmd. prägen - to shape sb.
schade - unfortunate
verbringen - to spend
die Kindheit - the childhood
aufmuntern - to encourage
das Rhythmusgefühl - the sense of rhythm
das Verständnis - the understanding
laienhaft - amateurish
der Knochen - the bone
steif - stiff
eingefroren - frozen
vorstellen - to present
das Schwein - the pig
nachgucken - to check
jmd. auf etw. aufmerksam machen - to bring sth. to someone's attention
aufpassen - to pay attention
der Klassenraum - the classroom
der Unterricht - the class
der Schwung - the momentum
erfreulich - delightful
auf etw. ankommen - to come down to sth.
der Tonfall - the tone
die Aussage - the statement
das Entscheidende - the key thing
etw. im Blut haben - have sth. in one's blood
sich benehmen - to behave
musikalisch - musically
das Ohr - the ear
die Neuigkeiten - the news
klingen - to sound
zu tun haben mit - to have to do with
glücklich machen - to make happy
wunderschön - beautiful
etw. (r)einfließen lassen - to incorporate sth.
unauffällig - discreetly
sich beschweren - to complain
fehlen - to be absent
dabei sein - to be present
jmd. raten - to recommend to sb.
sich interessieren - to be interested
die Geschichte - the history
so weit sein - to be ready
richtig - real
etw. sollen - to be supposed to do sth.
an Ort und Stelle - on the spot
unlesbar - unreadable
angeben - to show off
verloren sein - to be lost
kompliziert - complicatedly
scheinen - to seem
die Mode - the trend
notwendig - necessary
denken - to think
auf solchen Höhen - at such heights
dran reichen können - to be able to reach
die Wissenschaft - the science
sich mit etw. beschäftigen - to deal with sth.
entschlüsseln - to decode
sich bei etw. denken - to have sth. in mind
vorlesen - to read out
wie sich etw. anhört - how sth. sounds
anschauen - to look at
das Zitat - the quote
das Buch - the book
sich Sorgen machen - to worry
endlich - finally
lachen - to laugh
der Satz - the sentence
studieren - to go to college
sich bemühen - to make an effort
deutlich - clearly
sich ausdrücken - to express oneself
das Wissen - the knowledge
vermitteln - to impart
schlau - smart
der Schachtelsatz - the complex sentence
der Satzteile - the clauses
bewundern - to admire
der Inhalt - the content
im Hintergrund stehen - to be secondary
unterrichten - to teach
sich ausgrenzen - to isolate oneself
die Einleitung - the preamble
der Lehrer - the teacher
erwarten - to expect
die Vorbildung - the previous education
die Sprache - the language
beherrschen - to master
die experimentelle Musik - the experimental music
unvorbereitet - unprepared
unverständlich - inscrutable
so ähnlich - similar
in Form von - in the form of
behaupten - to claim
langwierig - tedious
schwierig - difficult
genießen - to enjoy
die Bekenntnisse - the confessions
der Kirchenlehrer - the church teacher
persönlich - personal
tief - profound
verstehen - to comprehend
Volksphilosoph - Philosopher of the People
der Begründer - the initiator
die Essayistik - essay writing
der Skeptiker - the skeptic
der Humanist - the humanist
empfehlen - to recommend
überzeugt sein - to be convinced
zugänglich - accessible
lustig - humorous
pfiffig - nifty
die Weltreise - the world trip
etw. anders sehen - to see sth. differently
etw. dazulernen - to learn sth. new
erwähnen - to mention
berühmt berüchtigt - infamous
formulieren - to phrase
überspitzt - hyperbolical
übertrieben - exaggerated
das Abenteuer - the adventure
gegen etw. wüten - to rampage against sth.
die sprachliche Gewalt - the linguistic force
eine Wut im Bauch haben - to be furious
schwindelig - dizzy
mit Sicherheit - surely
berühmt - famous
tot - dead
traurig - sad
auf etw. kommen - to think of sth.
das Chor-Konzert - the choir concert
rhythmisches Klatschen - rhythmic clapping
im Gleichtakt - in unison
furchtbar - dreadful
die Ausnahme - the exception
hinzufügen - to add
der Takt - the beat
stumpf - blunt
die Massendynamik - the mass dynamics
die Hosentasche - the trouser pocket
ohne mich - without me
jmd. böse angucken - to frown at sb.
klatschen - to clap
der Applaus - the applause
durcheinander - jumbled up
unsichtbar - invisible
die Kraft - the power
im Takt - in sync
die Schwarmintelligenz - the swarm intelligence
die Schwarmdummheit - the swarm stupidity
das Schlagzeug - the drums
laut - loud
leise - quiet
das Publikum - the audience
genau - exactly
stehen - to stand
miteinander reden - to talk to each other
der Künstler - the artist
respektlos - disrespectful
zumindest - at least
der Anfang - the beginning
etw. aushalten - to endure sth.
still in sich hinein ärgern - to quietly feel resentful
jmd. aufs Maul (hauen) (ugs.) - to punch someone (colloq.)
sich umdrehen - to turn around
in der Nähe - nearby
etw. besprechen - to discuss sth.
die Erfahrung - the experience
die Klappe halten (ugs.) - to keep one's mouth shut (colloq.)
gemaßregelt werden - to be reprimanded
nervig - annoying
könntet ihr wohl - could you please
quatschen - to blather
sich ins Ohr flüstern - to whisper in one's ear
schade - a shame
akustisch - acoustic
der Beitrag - the report
die Fernsehsendung - the tv show
der Eine oder Andere - some of you
das Insiderwissen - the insider knowledge
die Anspielung - the allusion
der Ausländer - the foreigner
nachvollziehen - to follow
inspiriert - inspired
eine der wenigen - one of the few
stark - strong
aufhören - to end
im Herbst - in autumn
die Sendung - the broadcast
das Hauptprogramm - the main program
untertitelt - subtitled
erzählen - to recount
worum etw. geht - what sth. is about
der Erste Weltkrieg - the First World War
ausrufen - proclaim
ehemalig - former
der Kaiser - the Emperor
die Abdankung - the abdication
unterschreiben - to sign
regieren - to govern
der Vertrag - the contract
heutzutage - these days
das englische Königshaus - the English royal family
das Schloss - the castle
Prinz von Preußen - Prince of Prussia
witzig - comic
der Anspruch - the claim
der König - the king
die Veranstaltung - the event
seine königliche Hoheit - His Royal Highness
jmd. ansprechen - to address sb.
die Wahnvorstellung - the delusion
etw. nachtrauern - to mourn sth.
aufwachsen - to grow up
ohne Ende - endless
reich - rich
der Typ - the guy
entschädigen - to compensate
verlieren - to lose
ausgezahlt - redeemed
das Wohnrecht - the right of residence
im Landesbesitz - state-owned
verrückt - bonkers
etw. auf die Agenda heben - to put sth. on the agenda
die Reichweite - the reach
die Bundesregierung - the Federal Government
die Verhandlung - the negotiation
das Gutachten - the expert opinion
die Entschädigung - the reparation
etw. steht jmd. zu - sb. is entitled to sth.
im Endeffekt - ultimately
sich entscheiden - to depend on sth.
in das Amt bringen - to bring into power
der Nationalsozialismus - National Socialism
Vorschub leisten - to abet
die Handlung - the action
etw. begünstigen - to facilitate sth.
unterstützen - to support
der Ausschluss - the exclusion
das Kriegsverbrechen - the war crime
der Völkermord - the genocide
das Opfer - the victim
der Zweite Weltkrieg - the Second World War
die Entschädigungsanfrage - the demand for reparation
die Klage - the lawsuit
abwehren - to avert
auf etw. hinweisen - to point sth. out
ernst - serious
in keinem Verhältnis stehen - to be out of proportion
die Empfehlung - the recommendation
der Liedtext - the lyrics
benutzen - to use
einrichten - to configure
interpretieren - to interpret
aussagen - to signify
die Zeile - the line
übersetzen - to translate
die Übung - the exercise
schummeln - to cheat
witzig - funny
der Liedermacher - the songwriter
bekannt - well-known
humorvoll - humorous
das Liebeslied - the love song
der Refrain - the chorus
die Strophe - the verse
sich verlieben - to fall in love
die Bedeutung - the meaning
etw. auswendig können - to know sth. by heart
aussuchen - to choose
auswählen - to pick
zusammenbauen - to assemble
etw. funktioniert nicht - sth. doesn't work
die Zusatzempfehlung - the additional recommendation
mögen - to like
anfangen - to get started
rausbringen - to put out
der Bassist - the bass player
der beste Freund - the best friend
kennen - to know
der Schneefall - the snowfall
gründen - to found
nennen - to call
schlecht - bad
die Gemeinde - the community
was hältst du davon - what do you think of it
der Aufruf - the appeal
die Hausaufgabe - the homework
verdienen - to deserve
die Werbung - the advertising
der Freund - the friend
etw. in die Welt posaunen - broadcast sth. into the world
mitbringen - to bring
etw. liegt jmd. am Herzen - sth. is dear to someone's heart
etw. einsprechen - to record sth.
etw. beantworten - to answer sth.
gespannt sein - to be curious
beides - both
darauf ankommen - to depend on
normalerweise - normally
etw. betonen - to emphasize sth.
das Pronomen - the pronoun
der Städtename - the city name
jmd. vorstellen - to introduce sb.
häufig - frequently
betonen - to emphasize
zitieren - to quote
ich wünschte - I wish
der Muttersprachler - the native speaker
natürlich - naturally
sich schämen - to be ashamed
Quatsch sein (ugs.) - to be nonsense (colloq.)
gesprochen - spoken
die Abwandlung - the modification
etw. verschriftlichen - to transcribe sth.
die Satzstellung - the word order
vollständig - complete
das Ziel - the objective
etw. klären - to sort sth. out
verwirrt werden - to become confused