leise - quiet
mitsingen - to sing along
der Hintergrund - the background
hören - to hear
denken - to think
die Anfrage - the request
der Text - the lyrics
etw. übernehmen - to handle sth.
sich etw. ausdenken - to think sth. up
verschwenden - to waste
bekannt sein für - to be known for
vielleicht - perhaps
trotzdem - anyway
das Wochenende - the weekend
im Exil sein - to be in exile
das Ruhrgebiet - the Ruhr area
bevölkerungsreich - populous
geboren sein - to be born
nicht mehr wissen - to not know anymore
unterwegs sein - to be out and about
immer was los sein - always sth. going on
reisen - to travel
zur Sache schreiten - to get down to business
anfangen - to get started
aufzeichnen - to record
die vorletzte - the penultimate
kompliziert - complicated
um etw. gehen - to be about sth.
bekommen - to get
vorlesen - to read out
sagen - to say
behaupten - to claim
schreiben - to write
berühmt - famous
der Künstler - the artist
legendär - legendary
Recht haben - to be right
stimmen - to be true
kultig - iconic
sich anfühlen - to feel
das Land - the country
geprägt sein - to be shaped
britisch - British
anders aussehen - to differ
die Heimat - the home
erwähnen - to mention
ehrlich gesagt - to be honest
jmd. etw. bewusst sein - to be aware of sth.
hinterlassen - leave sth.
die klassische Musik - the classical music
der Ausschnitt - the excerpt
die Lieblingsband - the favorite band
etw. hinzufügen - to add sth.
lebendig - lively
die Unterstützung - the support
stark - strong
beliebt - popular
besonders - special
glücklich - happy
die Musikhochschule - the School of Music
ähnlich - similar
die Möglichkeit - the possibility
der Bereich - the area
die Oper - the Opera
sich bewusst sein - to be aware
begeistert sein - to be enthusiastic
schwach - weak
nie - never
regelmäßig - regularly
der Sänger - the singer
studieren - to study
etw. mögen - to be into sth.
etw. gefällt jmd. - sb. likes sth.
das Lied - the song
ungefähr - approximately
das Wissen - the knowledge
bereit sein - to be ready
die Folge - the episode
der Unterton - the undertone
umgangssprachlich - colloquially
etw. falsch machen - to make a mistake
wegen - because of
danach - after
normalerweise - normally
der Beispielsatz - the example sentence
der Diebstahl - the theft
das Gefängnis - the prison
der Schüler - the student
sich anpassen - to adapt
täglich - daily
der Sprachgebrauch - the usage of language
anerkennen - to honor
falsch - false
außer - except
der Unterricht - the class
bestrafen - to punish
erwarten - to expect
beschreiben - to describe
die Regel - the rule
etw. annehmen - to accept sth.
untersuchen - to study
sich einig sein - to be in agreement
die Unsicherheit - the uncertainty
gefährlich - dangerous
für etw. sorgen - to be responsible for sth.
die Ästhetik - aesthetics
die Wohnung - the apartment
aus freiem Willen - of one's own free will
etw. vorschreiben - to prescribe sth.
sich aufregen - get worked up
benutzen - to use
der Quatsch (ugs.) - the nonsense (colloq.)
auf dem Teppich bleiben - to keep one's feet on the ground (colloq.)
der Ausdruck - the expression
im Endeffekt - ultimately
die Aussage - the statement
etw. so stehen lassen - to leave it at that
etw. beklatschen - to applaud sth.
auswählen - to choose
das Reisen - travelling
die Reise - the journey
zwangsläufig - inevitably
sich vorstellen - to imagine
wahrscheinlich - probably
die Weltreise - the world trip
unterwegs sein - to travel
sagt man das so - is it called that
der indische Subkontinent - the Indian subcontinent
relativ lange - relatively long
und so weiter - and so on
ziemlich - quite
beachtlich - remarkable
die Länge - the length
nicht jeder - not everyone
die Erfahrung - the experience
neidisch - jealous
anstrengend - exhausting
hauptberuflich - full-time
der Reisende - the traveller
sich ausmalen - to envision
Klagen auf hohen Niveau (ugs.) - complaining at a high level (colloq.)
unfassbar - inconceivable
nebenbei - on the side
einnehmen - to occupy
sich kümmern - to take care of
die Unterkunft - the accommodation
vergleichen - to compare
sich einlesen - to read up on
sich mit etw. auseinandersetzen - to engage with sth.
abhaken - to tick off
die Einstiegsfrage - the introductory question
überraschen - to surprise
weiterempfehlen - to recommend
die Hauptstadt - the capital
die Landschaft - the landscape
sich anschauen - to take a look
überrascht sein - to be surprised
ähnlich - to similar
etw. gehört jmd. - sth. belongs to sb.
unabhängig - independent
das Gleiche - the same
die Sprache - the language
die Gegenwart - the present
unterschiedlich - different
wahrnehmen - to perceive
sich wohl fühlen - to feel comfortable
wohingegen - whereas
herausfordernd - challenging
anerkennen - to acknowledge
die Unabhängigkeit - the independence
kämpfen - to fight
enttäuscht sein - to be disappointed
der Urlaub - the vacation
sich entspannen - to relax
kennenlernen - to get to know
das Abenteuer - the adventure
in dem Sinne - in that sense
die Enttäuschung - the disappointment
etw. beibringen - to teach sth.
einverstanden sein - to agree
die Entscheidung - the decision
etw. überdenken - to reconsider sth.
der Steinklotz - the stone block
die Wüste - the desert
wunderschön - gorgeous
die Stille - the silence
die Weite - the vastness
der Rückweg - the way back
der Ausläufer - the tail
die Schlaufe - the loop
das Hufeisen - the horseshoe
der Pferdefuß - the horse foot
plattgetrampelt - trampled flat
die Kante - the edge
der Aussichtspunkt - the viewpoint
klettern - to climb
sich festhalten - to hold on
die Angst - the anxiety
abstürzen - to fall down
sterben - to die
das Sicherheitsempfinden - the sense of security
nachgucken - to check
etw. ärgert jmd. - sth. irritates sb.
der Mülleimer - the trash can
in die Gegend schmeißen - to litter
recherchieren - to do research
geil aussehen - to look awesome
der Eintritt - the entrance
verwalten - to administer
die Gegend - the area
pinkeln - to pee
hinschmeißen - to throw away
unangenehm - unpleasant
der Ort - the place
überfluten - to flood
ein Teil davon sein - to be a part of it
die Belastung - the strain
die Bevölkerung - the population
der Wohlstand - the prosperity
gleichzeitig - at the same time
zu weit gehen - to go too far
die Umwelt - the environment
Schaden anrichten - to do harm
vermeiden - to avoid
sich vorbereiten - to prepare
bewusst - deliberately
der Mut - the courage
weniger - fewer
mutig - courageous
der Spaß - the fun
verlieren - to lose
der Reiseführer - the travel guide
sich Sachen angucken - to look at things
es wert sein - to be worth it
lernen - to learn
etw. Unspektakuläres - sth. unspectacular
wohnen - to live
spazieren gehen - to take a walk
mittlerweile - by now
etw. abstellen - to stop sth.
sich freuen - to be happy
empfinden - to perceive
der Grund - the reason
mögen - to like
treffen - to meet
einladen - to invite
die Begegnung - the encounter
der Turm - the tower
hundertprozentig - absolutely
der Zuschauer - the viewer
die Einladung - the invitation
die Sehenswürdigkeit - the attraction
der Wasserfall - the waterfall
der Großvater - the grandfather
die Empfehlung - the recommendation
abarbeiten - to get through
die Gastfreundschaft - the hospitality
die Heimlichkeit - the homeyness
sich heimlich fühlen - to feel homey
zu Hause - at home
fremd - alien
gastfreundlich - hospitable
stolz - proud
von Herzen - wholeheartedly
jmd. willkommen heißen - to welcome sb.
etw. erfahren - to experience sth.
jmd. einfallen - to occur to sb.
jmd. ähnlich gehen - to be similar for sb.
Zeit verbringen - to spend time
steif - stiff
ordentlich - neat
erfrischend - refreshing
außerhalb - outside of
prägend - shaping
anders - different
merken - to notice
in Frage stellen - to question
die Versicherung - the insurance
zufrieden - content
die Lebensumstände - the circumstances of life
befreiend - freeing
abgesichert - safeguarded
das Risiko - the risk
an der Tagesordnung sein - to be commonplace
der praktische Umgang - the practical handling
die Sicherheit - the safety
die Sorge - the worry
entscheiden - to decide
sich etw. widmen - devote oneself to sth.
der Austausch - the exchange
sich um etw. kümmern - to deal with sth.
verlassen - to leave
möglich - possible
der Umgang miteinander - the interaction with one another
der Schutzraum - the protective space
die Nähe - the proximity
die Schutzzone - the protected zone
der Abstand - the distance
die Schlange - the queue
der Vordermann - the person in front
dicht aneinander - close together
schwierig - difficult
etw. wahrnehmen - to perceive sth.
etw. bewerten - to judge sth.
der Unterschied - the difference
aufwachsen - to grow up
das Aufwachsen - growing up
das Bedürfniss - the need
das Volk - the people
die Sitte - the custom
die Grenze - the border
der Wert - the value
das Ziel - the goal
die Entwicklungsziele der Vereinten Nationen - the United Nations Development Goals
die Menschenrechte - human rights
etw. diktieren - to impose sth.
die Bedürfnis - the need
teilen - to share
die Anschauung - the view
sich verändern - to change
tolerieren - to tolerate
auf etw. zurückführen - to trace back to sth.
die Frauenrechte - women's rights
dominieren - to dominate
historisch - historically
jmd. unterdrücken - to oppress sb.
die Bestrebung - the pursuit
die Gleichberechtigung - the equality of rights
voranschreiten - to advance
die Menschheit - humanity
die Grenze - the boundary
die Rechte - the rights
der Glaube - the belief
in gewisser Weise - in a sense
das Tier - the animal
der Mensch - the person
erleben - to experience
der Stamm - the tribe
die Ureinwohner - the indigenous people
misshandeln - to abuse
sich anmaßen - to presume
belehren - to moralize
über Jahrhunderte - for centuries
einfallen - to invade
einmarschieren - to march in
gelten - to apply
in jeglicher Hinsicht - in all respects
verwerflich - reprehensible
jmd. aufdrängen - to impose on sb.
wegschauen - to look away
die Unterdrückung - the oppression
das Zitat - the quote
die Seite - the side
die Unterdrücker - the oppressors
stattfinden - to take place
die Unterdrückten - the oppressed
in die gleiche Richtung gehen - to be in the same vein
das schlechte Gewissen - the guilty conscience
am Rande - in passing
die Einstellung - the attitude
der Fußabdruck - the footprint
sich aufschreiben - to write down
der Flug - the flight
die Busfahrt - the bus trip
das Fortbewegungsmittel - the means of transport
der Konsum - the consumption
die Tonne - the ton
ausstoßen - to emit
einordnen - to contextualize
vergleichsweise - comparatively
inakzeptabel - unacceptable
etw. mitmachen (ugs.) - to sustain sth. (colloq.)
auf etw. hinweisen - to point sth. out
die Erkenntnis - the realization
nachdem - after
das Letzte - the last thing
verbieten - to proscribe
abraten - to discourage
das Reisen an sich - traveling itself
mit Abstand - by far
Schaden anrichten - to do damage
auf anderen Wegen - in other ways
ausgleichen - to compensate
der Vegetarier - the vegetarian
der CO2-Fußabdruck - the CO2 footprint
das Fleisch - the meat
auf etw. verzichten - to give sth. up
die Flugreise - the flight
reduzieren - to reduce
das Privileg - the privilege
sich erlauben können - to be able to afford
die moralische Verpflichtung - the moral obligation
gegensteuern - to take countermeasures
das Referat - the lecture
predigen - to preach
die Bewegung - the movement
etw. verlinken - to link to sth.
erklären - to explain
worum etw. geht - what sth. is about
der Verein - the organization
gründen - to found
der Schüleraustausch - the student exchange
etw. bewegt jmd. - sth. moves sb.
die Gelegenheit - the opportunity
teilnehmen - to participate
die Richtung - the direction
belasten - to burden
geprägt werden - to be shaped
das Wohl - the well-being
die Bildung - education
erreichen - to achieve
fördernswert - beneficial
der Austauschschüler - the exchange student
der Gedanke - the idea
die Weltkriege - the world wars
der Krieg - the war
wichtig - important
unterstützenswert - worthy of support
sich etw. erlauben können - to be able to afford sth.
etw. muss nicht sein - sth. is unnecessary
auf etw. zurückkommen - to come back to sth.
vorspielen - to play
der Schulbus - the school bus
raten - to guess
je länger - the longer
die Kneipe - the pub
betrunken - drunken
verstehen - to understand
der Satz - the sentence
krass (ugs.) - awesome (colloq.)
auf Achse sein - to (always) be on the move
weniger - less
die Achse - the axle
das Teil - the part
das Fahrzeug - the vehicle
das Auto - the car
unterwegs sein - to be traveling
die Tante - the aunt
die Verwandten - the relatives
ein Satz fällt - a sentence is used
die Frage - the question
die Zuhörerin - the listener
die Welt - the world
verschiedene - different
gut passen - to go well
gespannt sein - to be curious
der Kulturwissenschaftler - the cultural scientist
je mehr … desto mehr - the more ... the more
selbstverständlich - self-evident
entdecken - to discover
sich entwickeln - to evolve
die Außenwelt - the outside world
aufweisen - to feature
die Ähnlichkeit - the similarity
erziehen - to raise
ähnlich - similarly
der Begriff - the term
breit - broad
unabhängig - independently
die Pyramide - the pyramid
bauen - to build
deutlich - conspicuous
die Verschwörungstheorie - the conspiracy theory
der Außerirdische - the extraterrestrial
beeinflussen - to influence
entwickeln - to develop
die Schrift - the writing
der Gedanke - the thought
nicht umsonst sein - to have a good reason
passieren - to come about
gemeinsam - in common
für etw. sorgen - to make sure of sth.
inhärent - inherent
auf etw. hinauslaufen - to result in sth.
sich unterhalten - to talk
die Vorstellung - the notion
übersetzen - to translate
so eine Art - a sort of
die Vernunft - the reason
die Pflanze - the plant
beobachten - to observe
sich benehmen - to behave
das Gehirn - the brain
vorherrschen - to prevail
sich rausnehmen - to exclude oneself
schlau - smart
überrascht sein - be surprised
jmd. kennenlernen - to get to know sb.
etw. kennen - to be familiar with sth.
von etw. gehört haben - to have heard of sth.
die Erklärung - the explanation
kostenlos - free
übernachten - to spend the night
auf der ganzen Welt - all around the world
unterstützen - to support
das Wohnzimmer - the living room
das Gästezimmer - the guest room
das Bett - the bed
zur Verfügung stellen - to make available
besuchen - to visit
schlafen - to sleep
günstig - inexpensively
Geld sparen - to save money
etw. erreichen - to achieve sth.
jmd. beherbergen - to host someone
austauschen - to exchange
gegenseitig - one another
die Angst - the fear
unsicher - unsafe
die Bewertung - the review
zu etw. passen - to go with sth.
empfehlenswert - recommendable
der Teufel wohnt nebenan - The Devil Next Door
ab und zu - now and then
um etw. handeln - to be about sth.
der Zweite Weltkrieg - the Second World War
der KZ-Wärter - the concentration camp guard
ursprünglich - originally
übtertreten - to go over
das KZ (Konzentrationslager) - the concentration camp
die Juden - the Jews
untertauchen - to disappear
jmd. auffallen - to attract sb.'s attention
beschreiben - depict sb./sth.
vor Gericht stellen - to bring to justice
ausbürgern - to expatriate
jmd. verurteilen - to sentence sb.
jmd. freisprechen - to exonerate sb.
die Kurzfassung - the abridged version
als Mensch überhaupt - as a human being in general
in diesen Tagen - these days
der Menschenhass - the hatred of people
der Faschismus - fascism
kaputtmachen - to destroy
das Opfer - the victim
etw. neu durchleben - to relive sth.
der Anwalt - the lawyer
jmd. angreifen - to assault sb.
sich umbringen - to kill oneself
die Dokumentation - the documentary
natürlich - of course
gucken - to watch
stimmt - right
die Sache - the thing
empfehlen - to recommend
der Bezug - the relation
traurig - sad
auf etw. bestehen - to insist on sth.
ein Teil von - part of
der Bandname - the band name
am Rande - as an aside
die Berichtigung - the correction
die Insel - the island
die Nordsee - the North Sea
in den Urlaub fahren - to go on holiday
die Zeit - the time
der Stadtteil - the district
der Ohrwurm - the catchy tune
die Form - the shape
anfertigen - to build
gute Laune machen - to lighten the mood
unter sich sein - to be among oneself
prägend - formative
hässlich - ugly
wunderschön - lovely
die Reichen - the rich
die Promis (ugs.) - the celebrities (colloq.)
leider - unfortunately
unnütz - useless
das Geschäft - the shop
der Juwelier - the jeweler
teuer - expensive
der Schmuck - the jewelry
das Abendessen - the dinner
sich reinziehen (ugs.) - to eat, drink or watch (colloq.)
die Billig-Urlauber - the cheap vacationers
etw. für sich beanspruchen - to claim sth. for oneself
beantworten - to answer
hinterlassen - to leave
die Episodenseite - the episode page
aus Zeitgründen - for lack of time
zufällig - coincidentally
gut passen - to be a good fit
liebe Grüße - warm greetings
etw. genießen - to enjoy sth.
der Wortschatz - the vocabulary
erweitern - to broaden
insbesondere - in particular
etw. gemeinsam haben - to have sth. in common
sich ausdenken - to think up
tiefgehend - profound
witzigerweise - funnily enough
etw. festhalten - to record sth.
in Erinnerung bleiben - to be remembered
jmd. auffallen - to notice
was etw. betrifft - with regard to sth.
die Gewohnheit - the habit
der Brauch - the custom
etw. ausmachen - to constitute sth.
brauchen - to need
in Sicherheit sein - to be safe
geliebt werden - to be loved
lieben - to love
wichtige - important
die Lektion - the lesson
sich vorhalten - to remind oneself
jmd. auffalen - to notice
eine gewisse Masse - a certain amount
die Wiederholung - the repetition
das Gesicht - the face
das Lachen - the laughter
der Witz - the joke
der Humor - the sense of humor
egal - irrelevant
der Gesichtszug - the facial feature
der Charakterzug - the character trait
an dem Punkt - at the point
sich wiederholen - to repeat itself
die Geschichte - the story
etw. merken - to notice sth.
die Gemeinsamkeit - the common ground
enstehen - to arise
am Ende - in the end
das Fazit - the conclusion
einfach mal Mensch sein - just be human
die Weisheit - the wisdom
das Prinzip - the principle
fortsetzen - to continue
dranbleiben - to stay tuned