warten - to wait
normalerweise - normally
schreien - to shout
heute - today
der Gast - guest
sich dem Ende zuneigen - to come to an end
sich etw. vornehmen - to plan to do sth.
spezifisch - specifically
sich kennen - to know each other
der Einstieg - introduction
ansonsten - otherwise
bekannt - known
die Ausstellung - exhibition
kuratieren - to curate
herausbringen - to publish
sich mit etw. beschäftigen - to engage with sth.
die Geschichte - history
das Videospiel - video game
darstellen - to represent
sich verändern - to change
verschwinden - to disappear
der Inhalt - content
der Entwickler - developer
der Forscher - researcher
zusammenfassen - to summarize
forschen - to research
sich mit etw. auseinandersetzen - to deal with sth.
überrascht sein - to be astonished
unter dem Radar laufen - to fly under the radar
etw. konservieren - to preserve sth.
etw. beruflich machen - to pursue a career
das Computerspiel - computer game
auf etw. kommen - to conceive of sth.
gut passen - to go well
die gesellschaftliche Entwicklung - social development
die Wechselwirkung - interdependency
der Begriff - term
in die Tiefe gehen - to go deep
mit etw. zu tun haben - to be connected to sth.
belastet - charged
sich nennen - to call oneself
sich überidentifizieren - to overidentify
verknüpfen - to relate
passen - to fit
ausgrenzen - to exclude
die Wut - rage
die Gewalt - violence
die Überleitung - transition
die Vorstellung - introduction
sich überlegt haben - to have come up with
die Privilegierung - privileges
zusammen - together
tief - deep
in den Sinn kommen - to come to mind
das Reisen - traveling
die Weltreise - world trip
verwehrt bleiben - to not be able to
recherchieren - to research
ursprünglich - originally
das Gesetz - (specific) law
jmd. betreffen - to affect sb.
das Recht - law
der Krankenwagen - ambulance
die Ampel - traffic light
im Sinne von - in terms of
die Gleichberechtigung - equal rights
der Gegenspieler - other side
die Diskriminierung - discrimination
die Geburt - birth
das Grundgesetz - German Constitution
das Geschlecht - gender
die Abstammung - descent
die Herkunft - origin
der Glauben - faith
die Anschauung - views
jmd. benachteiligen - to disadvantage sb.
jmd. bevorzugen - to favor sb.
die Behinderung - disability
das Vorwort - preface
beschreiben - to describe
die Möglichkeit - possibility
privilegiert - privileged
offensichtlich - evident
geboren sein - to be born
arm - poor
reich - rich
der Wohnraum - housing
sich etw. leisten können - be able to afford sth.
jmd. etw. zuweisen - to assign sth. to sb.
sich wohl fühlen - to be comfortable
das Gegenstück - counterpart
entsprechen - to correspond to
auf die Welt kommen - to be born
das Bein - leg
als etw. angesehen werden - to be viewed as sth.
die Abweichung - deviation
die Ebene - level
die Gesundheit - health
chronisch krank - chronically sick
das Gesundheitssystem - healthcare system
die Hilfe - help
die Krankenversicherung - health insurance
sich verschulden - to go into debt
verknüpft sein - to be linked
an anderen Stellen - at other places
ineinander spielen - to interact
die Erfahrung - experience
miteinander verknüpft sein - go hand in hand
der Schmerz - pain
zuerkennen - to acknowledge
der Unterschied - difference
den Blöden spielen - to play dumb
sich mit etw. beschäftigen - to engage in sth.
blöd spielen - to play dumb
bei null anfangen - begin at zero
vor längerer Zeit - some time ago
weiß - white
leicht - easy
durchs Leben gehen - to go through life
zum ersten Mal - for the first time
etw. auffallen - to notice sth.
die Wandlung - conversion
etw. wahrnehmen - to perceive sth.
die Abneigung - aversion
gleichberechtigt - to have equal opportunities
die Umgebung - environment
aufwachsen - to grow up
benachteiligt - disadvantaged
das Gegenteil - opposite
der Alltag - everyday life
sich mit etw. auseinandersetzen - to engage with sth.
die Grenze - limit
ständig - constantly
anders - different
zwangsläufig - inevitably
die Mehrheitsgesellschaft - majority society
das Gespräch - conversation
im Endeffekt - at the end of the day
keine andere Wahl haben - to have no other choice
sich befinden - to be situated
die Unterstützung - support
sich einreden - to convince oneself
nicht so schlimm - not too bad
behindert - disabled
es schwerer haben - to be worse off
auf etw. gestoßen werden - to come across sth.
die Aufgabe von jmd. sein - to be sb.'s job
jmd. etw. beibringen - teach sth. to sb.
zuhören - to listen
sich eignen - to be suitable
jmd. ausbeuten - to exploit sb.
erklären - to explain
anhören - to listen to
durch die Gegend laufen - to run around
sichtbar machen - to make visible
empfehlen - to recommend
sich zurücknehmen - to hold back
jmd. unter Druck setzen - to put pressure on sb.
erwarten - to expect
wahrnehmen - to perceive
vermissen - to miss
wollen - to want to
anfangen - to begin
jmd. einfallen - to occur to sb.
erzählen - to tell
von etw. ausgehen - to assume sth.
die Verletzung - wound
nach außen tragen - to show outwardly
doppelt belasten - to burden twice
Erfahrung sammeln - to gain experience
sich bewusst werden - to become aware
Schritt für Schritt - little by little
jmd. klar werden - to become clear to sb.
ausschlaggebend - deciding
überhaupt - anyway
anfangen - to start
der Austausch - exchange
der Verein - organization
das Vorurteil - prejudice
abbauen - to reduce
an etw. teilhaben lassen - to share in sth.
kennenlernen - to get to know
hinterfragen - to challenge
außerhalb des Dunstkreises - outside the range of vision
unmöglich - impossible
auf Augenhöhe - at eye level
herstellen - to create
das Einreisegesetz - immigration law
die Diskriminierungserfahrung - experience of discrimination
in der Minderheit sein - to be in the minority
passieren - to happen
jmd. zuschreiben - to ascribe to sb.
erfolgreich - successful
verankert sein - to be rooted
die Hautfarbe - color of the skin
auf Reise sein - to be traveling
die Geschichte - story
vor kurzem - recently
die Bezahlung - salary
was etw. betrifft - with regard to sth.
auf dem Schirm haben (ugs.) - to be aware of (colloq.)
die Überraschung - surprise
das Job-Gesuch - job search
die (Klein-)Anzeige - (classified) ad
schon öfter - many times before
etw. ins Internet stellen - to post sth. on the Internet
oder was auch immer - or whatever
in jedem Fall - always
das seriöse Angebot - serious offer
erhalten - to receive
mit etw. überschüttet werden - to be showered with sth.
unangemessen - improper
unangebracht - inappropriate
mit etw. belastet werden - to be burdened with sth.
eklig - disgusting
vor der Kamera stehen - to stand in front of the camera
der Hübsche - handsome guy
unter die Gürtellinie gehen (ugs.) - to go below the belt (colloq.)
das Mädchen - girl
die Mehrheit - majority
Gott sei Dank - thankfully
heiraten - to marry
etw. merken - to notice sth.
schicken - to send
anrufen - to call
krass - blatant
das Gefühl - sense
angemessen - appropriate
sich sicher fühlen - to feel safe
auf jmd. anspringen (ugs.) - to be attracted to sb.  (colloq.)
das Sexualdelikt - sexual offence
betroffen sein - to be affected
berühmt - famous
die Schauspielerin - actress
in der Lage sein - to be able
selbstbewusst - self-confident
die Macht - power
das Geld - money
in den meisten Fällen - in most cases
missbrauchen - to abuse
sich zurückziehen - to withdraw
das Machtgefälle - power imbalance
sich anders verhalten - to behave differently
gleichberechtigt sein - to enjoy equal rights
nicht der Fall sein - to not be the case
konkretisieren - to make concrete
genießen - to enjoy
der Beruf - profession
der Verbündete - ally
die Auftragslage - order situation
sich dumm stellen - to play dumb
jmd. auf etw. ansprechen - to ask sb. about sth.
sich verhalten - to conduct oneself
etw. andeuten - to hint at sth.
das Allerwichtigste - most important thing
das Nonplusultra (ugs.) - the perfect thing (colloq.)
jmd. ernst nehmen - to take sb. seriously
abwehren - to fend off
die Abwehrhaltung - defensive attitude
wichtig - important
kleinreden - to play down
das Gedankenspiel - mental game
mit etw. um die Ecke kommen (ugs.) - to start with sth. (colloq.)
etw. sacken lassen - to let sth. sink in
die Grundlage - foundation
die Stimme - voice
etw. Raum geben - to give space to sth.
verschenken - to give away
jmd. einladen - to invite sb.
senden - to broadcast
jmd. eine Plattform geben - to give sb. a platform
sich in den Mittelpunkt stellen - to put oneself in the limelight
hilfreich - useful
unter dem Vorwand - under the pretext
geschäftlich - business-related
locken - to lure
der Übergriff - assault
Raum schaffen - to create space
stattdessen - instead
von vornherein - at the outset
um etw. gehen - to be about sth.
jmd. einen Gefallen tun - to do sb. a favor
auf etw. achten - to consider sth.
falsch laufen - to go wrong
stattfinden - to take place
männerdominiert - male-dominated
die Unternehmensführung - corporate management
die Frauenquote - gender quota
Feind von etw. sein - to be against sth.
Lust auf etw. haben - to want to do sth.
die Gesprächskultur - culture of discussion
ausgeprägt sein - to be prominent
die Redezeit - speaking time
in Anspruch nehmen - to occupy
der Ausdruck - expression
kämpfen - to fight
sich ausdrücken - to express oneself
männlich - male
auffallen - to notice
ernst genommen werden - to be taken seriously
das Unternehmen - business
die Führungsebene - management level
mitspielen (ugs.) - to participate (colloq.)
betreiben - to practice
sich an die Regeln halten - to follow the rules
etw. sanktionieren - to penalize sth.
sich auf etw. einlassen - to go along with sth.
anstrengend - difficult
in Anführungszeichen - in quotation marks
bedrohlich - threatening
laut werden - to raise one's voice
schreien - to yell
sich durchsetzen - to assert oneself
sich nicht alles bieten lassen - to not put up with everything
merken - to realize
sogar - even
das Rumschreien - shouting
das Lügen - lying
angesehen sein - to be respected
ehrlich - honest
auf etw. Lust haben - to feel like sth.
sich engagieren - to be involved
sich durchschlagen - to struggle along
nerven - to annoy
furchtbar - terribly
die Ungleichheit - inequality
das Gesetz - law
von etw. halten - to think about sth.
der Vorstand - board of directors
die Chefetage - executive floor
hinkommen - to reach
der Vortrag - talk
die quotierte Redeliste - allocated speaking list
auf etw. achten - to watch out for sth.
drankommen - to get their turn
am Anfang - at the beginning
krampfig - cramped
sich an etw. gewöhnen - to get used to sth.
angenehm - pleasant
die Kleinigkeit - little thing
der Entscheidungsprozess - decision-making process
etw. ausgleichen - to compensate for sth.
anstatt - instead of
als ob - as if
bewusst - deliberately
ausgeglichen - balanced
verpflichtend - mandatory
die Selbstverpflichtung - voluntary agreement
verändern - to change
Sinn machen - to make sense
die Entscheidung - decision
gelten - to be valid
die Veranstaltung - event
ins Gespräch kommen - to start talking
anfragen - to inquire
antworten - to reply
sich bemühen - to make an effort
wenigstens - at least
andersweitig - otherwise
durchmischt - mixed
der Bereich - area
die Vielfältigkeit - diversity
die Gesellschaft - society
abdecken - to cover
die Fernsehsendung - TV show
die Absage - rejection
Wert auf etw. legen - to value sth.
der größte Promi - biggest celebrity
zu Gast sein - to be a guest
eine Bühne bieten - to give a stage
in die richtige Richtung gehen - to go in the right direction
die Bemühung - effort
der Gedanke - thought
lebendig - lively
zum Ende kommen - to finish
das Gefühl haben, dass - to feel that
in dieser Hinsicht - in this respect
sich verbessern - to improve
sich verschlechtern - to get worse
gleich bleiben - to remain the same
der Ausblick - outlook
etw. aushalten - to endure sth.
die Veränderung - change
die Gegenwehr - resistance
Angst machen - to frighten
das Erstarken - rise
in Heime stecken - to institutionalize
billig - cheap
jmd. versorgen - to provide for sb.
jmd. ausschließen - to exclude sb.
der Fortschritt - progress
der Rückschritt - regression
bedeuten - to mean
die Gegenreaktion - counter-reaction
vorhersehbar - predictable
begreifen - to understand
die Menschheit - humanity
in der Richtung - that way
die Abhängigkeit - dependence
ausgeprägt - pronounced
die düstere Zeit - dark days
die düster Zeit - dark days
eine Ahnung haben - to have a hunch
wo es hingehen soll - where we are headed
ausdrücken - to express
stehen bleiben - to stand still
zurückgehen - to go back
sich entwickeln - to evolve
für immer andauern - to continue forever
um etw. streiten - to fight for sth.
jmd. kennenlernen - to get to know sb.
die Notiz - note
etw. vorbereiten - to prepare sth.
uff (ugs.) - phew (colloq.)
während - while
sich etw. überlegen - to think of sth.
übersehen - to overlook
vergessen - to forget
die Sprechblase - speech bubble
im echten Leben - in real life
doch - yes (you do)
das Peinliche - embarrassing thing
der Quatsch (ugs.) - bullshit (colloq.)
das Seufzen - sigh
sich verzetteln - to lose the threat (colloq.)
die Bedeutung - meaning
bekräftigend - affirming
im Zusammenhang mit - in the context of
die Anstrengung - effort
die Belastung - burden
die Tüte - bag
der Einkauf - shopping
die Etage - the floor
hochtragen - to carry up
ständig - all the time
bekloppt (ugs.) - wacky (colloq.)
etw. nachreden - to repeat sth.
witzig - funny
schlechte Nachrichten - bad news
sich etablieren - to become established
etw. teilen - to share sth.
belastend - burdening
etwas Passendes - something fitting
der Radiobeitrag - radio report
der Radiosender - radio station
die Ungerechtigkeit - injustice
der Beitrag - contribution
etw. empfehlen - to recommend sth.
der Zuhörer - listener
gleichzeitig - simultaneously
die Übung - exercise
sich auswirken - to impact
besprechen - to discuss
etw. aufarbeiten - to work through sth.
mögen - to like
die Schrift - font
der Untertitel - subtitle
das Kurzporträt - short portrait
leben - to live
ungefähr - approximately
meistens - usually
der Migrationshintergrund - migration background
was es heißt - what it means
die Identität - identity
behaupten - to maintain
der Großteil - a large part
der Hintergrund - background
die Eltern - parents
vereinen - to combine
zugehörig - belonging
betrachtet werden - to be considered
das Beispiel - example
die TV-Persönlichkeit - TV personality
die Kindheit - childhood
teilweise - in some cases
adoptiert - adopted
die Nachbarschaft - neighborhood
das Dorf - village
der Beitrag - report
definieren - to define
schieben - to move
erst neulich - just recently
etw. gezeigt bekommen - to be shown sth.
die soziale Ungerechtigkeit - social injustice
im Großen und Ganzen - by and large
dankbar - grateful
umherreisen - to travel around
die Zeile - song line
jmd. zurechtstutzen - to tell sb. off
auf rechts spucken - to spit on the right-wing
etw. korrekt nutzen - to use sth. correctly
mehrmals - repeatedly
mittlerweile - nowadays
benutzen - to use
auf etw. zurückkommen - to come back to sth.
die Liedzeile - song line
weiblich - female
das Kind - child
die Verniedlichung - minimization
der Junge - child
behalten - to keep
gleichgestellt - equal
auf etw. hinweisen - to indicate sth.
die Behandlung - treatment
die Verkleinerungsform - diminutive form
die Magd - maid
unverheiratet - unmarried
sich durchsetzen - to catch on
immer - always
sich mit etw. auseinandersetzen - to grapple with sth.
die Schreibweise - spelling
der Unterstrich (_) - underscore (_)
das Sternchen (*) - asterisk (*)
etw. abbilden - to reflect sth.
die Bewegung - motion
die Bezeichnung - term
über etw. nachdenken - to think about sth.
in meinem Alter - at my age
das Mädel (ugs.) - gal (colloq.)
die Dame - lady
edel - fancy
der Typ - dude
der Kerl - guy
erwachsen - adult
dazwischen - in between
etw. ansprechen - to address sth.
der sogenannte - the so-called
das generische Maskulinum - generic masculine
in der Regel - usually
sich schwer mit etw. tun - to find it hard to do sth.
feststellen - to find
es spricht nichts dagegen - there's no reason why not
die Hörerin - listener (f)
sich ausgeschlossen fühlen - to feel left out
jmd. auch mal so gehen - be like that for sb. for once
ausgleichende Gerechtigkeit (ugs.) - poetic justice (colloq.)
etw. recherchieren - to research sth.
das Schriftliche - the written word
hinterherhinken - to lag behind
sich anpassen - to adapt
gendergerecht - gender-equitable
sich etw. bewusst machen - to be conscious of sth.
kontinuierlich - continuously
jmd. vor Augen führen - to make sb. aware
schwierig - difficult
etw. einführen - to institute sth.
die Regel - rule
die Sendung - show
locker flockig (ugs.) - easy breezy (colloq.)
jmd. verabschieden - to send sb. off
sich etw. wünschen - to ask for sth.
zum Ende des Jahres - at the end of the year
lustig - funny
ernst - serious
etw. ausschließen - to exclude sth.
Silvester - New Year's Eve
bewusst - aware
sich etw. vornehmen - to intend to do sth.
der Vorsatz - resolution
erreichen - to accomplish
das ist schon mal was (ugs.) - that's already an accomplishment (colloq.)
beruflich - job-related
aktuell - current
größer - larger
das Büro - office
brauchen - to need
die (Arbeits-)Kraft - employee
verdienen - to earn
das Ziel - goal
durcharbeiten - work without pause
Weihnachten - Christmas
im Urlaub - on vacation
Vollzeit - full time
etw. ermöglichen - to make sth. possible
das Mitglied - member
etw. möglich machen - to make sth. possible
gesünder leben - to live healthier
abnehmen - to lose weight
messbar - measurable
schwammig - vague
auf ein Ziel hinarbeiten - to work towards a goal
die Ernährung - diet
Teil von etw. sein - to be part of sth.
der Abschluss - conclusion
dazu übergehen - to switch to
im Laufe des Jahres - in the course of the year
zeitlich begrenzen - to limit in time
meditieren - to meditate
auf Jahresbasis - on an annual basis
der Abstand - distance
laufend - ongoing
schwer messbar - difficult to measure
vergleichen - to compare
die Enttäuschung - disappointment
der Spruch - phrase
an etw. arbeiten - to work on sth.
sich etw. vorstellen können - to be able to imagine sth.
ständig - permanently
abgelenkt sein - to be distracted
die Zukunft - future
die Vergangenheit - past
das Hier und Jetzt - the here and now
das Abendessen - dinner
Aufholbedarf haben - to need to work on sth.
umgekehrt - the other way around
etw. aufgeben - to give sth. up
sich geschlagen geben - to admit defeat
es kann sein, dass - it is possible that
sich etw. angucken - look at sth.
stundenlang - for hours
der Wäschesack - laundry bag
um die Ecke - around the corner
sich erschrecken - to get scared
jagen - to chase
Guten Rutsch! - Have a good New Year!
Rutschikowski! (ugs.) - Have a good New Year! (colloq.)