unterwegs sein - to be on the way
deswegen - that's why
gucken - to look
quasi - basically
auf Reisen sein - to be traveling
der Dauerreisende - constant traveller
das Abenteuer - adventure
der Turm - tower
das Kissen - cushion
etw. anschließen - to plug sth. in
sich entschuldigen - to apologize
klingen - to sound
der Krach - noise
der Hintergrund - background
die Schweiz - Switzerland
der Sirenenalarm - siren alarm
aufregend - exciting
der Bunker - bunker
der Höllenlärm (ugs.) - a lot of noise (colloq.)
furchtbar - horrible
sich etw. gönnen - to treat oneself
ungewohnt - unusual
mit jmd. auskommen - to get along with sb.
planen - to plan
die Ruhe - silence
etw. aufnehmen - to record sth.
rumlaufen (ugs.) - to walk around (colloq.)
der Feind - enemy
überrascht sein - to be surprised
das Vorurteil - prejudice
reserviert sein - to be reserved
 jmd. einladen - to invite someone
helfen - to help
jmd. kennenlernen - to get to know someone
begeistert sein - to be excited
allein durch - solely by
etw. bestätigen - to confirm sth.
das lebenswerteste Land - most livable country
zumindest - at least
ziemlich - quite 
sich interessieren - to be interested
raten - to guess
glücklich  - happy 
natürlich - of course
verschieden - various
die Umfrage - survey
der Trommelwirbel - drum roll
die Macht - power
die Gleichstellung - equality
die Lebensqualität - quality of life
verwundernswert - surprisingly
insgesamt - total
das viertbeste Land - fourth best country
unangenehm - uncomfortable
die Benennung - title
der Umzug - move
etw. absagen - to cancel sth.
Tipps austauschen - to share tips
etw. nutzen - to take advantage of sth.
jmd. etw. erzählen - to tell sth. to someone
kompliziert - complicated
jedenfalls - anyway
sozusagen - so to speak
jmd. einen Tipp geben - to give sb. a tip
kurzfristig - short-term
langfristig - long-term
etw. loswerden - to get rid of sth.
erreichbar sein - to be available
etw. anreißen - to broach sth.
der Rassismus - racism
der Wohnungsmarkt - housing market
auf etw. eingehen - to go into sth.
etw. erwähnen - to mention sth.
die Bedenken - concerns
der Einwanderer - immigrant
etw. zugeben - to admit sth.
trotzdem - nevertheless
das Armutszeugnis - proof of inadequacy
weltoffen - liberal-minded
die Schwierigkeit - difficulty
die Wohnungssuche - apartment hunting
traurig - sad
die Erfahrung - experience
die Offenheit - openness
etw. verbessern - to improve sth.
die Rückmeldung - feedback
teilen - to share
der Nachteil - disadvantage
der Vorteil - advantage
im Endeffekt - effectively
das Zimmer teilen - to share a room
zwangsläufig - inevitably
kompromissbereit - willing to compromise
schade - too bad
offen für etw. sein - to be open to sth. 
gleichzeitig - at the same time
ausgeprägt - distinctive
etw. aufgeben - to give up sth.
an etw. teilnehmen - to take part in sth.
die Belustigung - amusement
die gleiche Meinung teilen - to share the same opinion
bestimmte Dinge - certain matters
dankbar - grateful
die Gelegenheit - occasion
die Weltanschauung - ideology
in zweierlei Hinsicht - in two respects
das Umfeld - background
aufwachsen - to grow up
die Ansicht - view
bereichernd - enriching
entsprechend  - according to 
der Umgang - handling
der Nationalsozialismus - National Socialism
angespannt sein - to be tense
ernst - serious
die Vergangenheit - past
die Gegenwart - present
der Gegenwart wegen - because of the present
etw. behaupten - to claim sth.
das heutige Deutschland - today's Germany
mit etw. umgehen - to deal with sth.
etw. thematisieren - to make sth. a subject of discussion
die Hemmung - inhibition
beziehungsweise - respectively
etw. gerecht werden - to do sth. justice
der Ausdruck - expression
etw. verlangt Respekt - sth. demands respect
die Aufmerksamkeit - attention
die Angst - fear
respektlos - disrespectfully
etw. verdient Aufmerksamkeit - sth. deserves attention
vor etw. Angst haben - to be afraid of sth.
jmd. motivieren - to motivate sb.
etw. besprechen - to discuss sth.
das Schlimmste - the worst
zahlreich - numerous
die Opfer - victims
die Herangehensweise - approach
unangebracht - inappropriate
der Vergleich - comparison
die Angespanntheit - tenseness
mit offenem Herzen - with an open heart
etw. falsch verstehen - to misunderstand sth.
etw. betreffen - concerning sth.
mit etw. auseinandersetzen - to take a look at sth.
heutzutage - nowadays
abgesehen von - besides
AfD (Alternative für Deutschland) - Alternative for Germany (right-wing populist party)
mindestens - at least
etw. verharmlosen - to play sth. down
etw. infrage stellen - to question sth.
umgehen - to deal with sth.
etw. einschätzen - to assess sth.
etw. verarbeiten - to assimilate sth.
etw. nutzen - to use sth.
die Zukunft - future
überlegen - to consider
der Geschichtslehrer - history teacher
jmd. etw. vermitteln - to convey sth. to somebody 
die Begegnung - encounter
der Rahmen - context
jüdisch - Jewish
fliehen - to flee
die Staatsbürgerschaft - citizenship
die Staatsbürgerschaft annehmen - to take citizenship
das Enkelkind - grandchild
auswandern - to emigrate
beeindruckend - impressive
die Begegnung - meeting
etw. ist möglich - sth. is possible
an dieser Stelle - at this point
überhaupt - in the first place
zurückkehren - to return
etw. thematisieren - make sth. a subject of discussion
die Einstiegsfrage - introductory question
als erstes - first of all
an etw. erinnern - to remember sth.
zum ersten Mal - for the first time
die Vergangenheit - past 
vermuten - to guess
später - later
mit etw. anfangen - to start with sth.
darüber sprechen - to speak about it
das Alter - age
zu klein sein - to be too young
schlimm - terrible
das Verbrechen - crime
die Ermordung - murder
sich vorstellen - to imagine
ungefähr - approximately
hören - to listen to
die Geschichte - history
sich unterhalten - to talk
was passiert ist - what has happened
etw. empfehlen - to recommend sth.
das Tagebuch - diary
etw. ansehen - to take a look at sth.
ich selber - I myself
jedoch - but
das Bewusstsein - awareness
etw. abspeichern - to save sth.
ehemalig - formerly
das Konzentrationslager - concentration camp
einschneidend - incisive
das Erlebnis - moment
erschlagen sein - to be overwhelmed
beschämt sein - to be ashamed
sich mit etw. auseinandersetzen - to deal with sth.
sicherlich - certainly
emotional berührt werden - to be touched emotionally
die Gedenkstätte - memorial
die ähnliche Erfahrung - similar experience
zu dem Zeitpunkt - at that time
etw. in der Schule durchnehmen - to do a subject at school
im Grunde - fundamentally
das Geschichtsbuch - history book
das Grundstück - property
spazieren gehen - to take a walk
die Baracke - barrack
der Koffer - suitcase
zurückfahren - to drive back
das Gepäck - luggage
etw. aufstapeln - to stack sth.
etw. ausstellen - to exhibit sth.
der Schlag in die Magengrube (ugs.) - punch in the stomach (colloq.)
das Erlebnis - experience
mehrmals - several times
jmd. begleiten - to guide sb.
die Schülergruppe - group of students
dorthin - there
unglaublich - incredible
das Lager - camp
etw. vergrößern - to extend sth.
eindringlich - vividly
genau wie bei dir - same as you
die Schwierigkeiten - difficulties
der Wahnsinn - madness
unvorstellbar - inconceivable
etw. thematisieren - to bring sth. up
geschockt sein - to be shocked
krass (ugs.) - extreme (colloq.)
niemand - nobody
die Brutalität - brutality
etw. bewirken - to cause sth.
etw. vermitteln - to communicate sth.
das Schicksal - fate
etw. annehmen - to embrace sth.
eine Distanz schaffen - to create distance
etw. sehen - to see sth.
eben - just
sonst - usually
plötzlich - suddenly
dramatisch - dramatically
einem wird schlecht dabei - it makes one sick
etw. bekommen - to receive sth.
im Speziellen - in particular
eigentlich - actually
darüber sprechen - to talk about
darüber - about it
wissen - to know
die Großeltern - grandparents
der Krieg - the war
etw. beginnen - to begin sth.
die Partei - party
sich etw. anschließen - to associate oneself with sth.
der Soldat - soldier
dementsprechend - correspondingly
das Flugzeug - plane
schwierig - difficult
gefährlich - dangerous
im Nachhinein - with hindsight
urteilen - to judge
die heutige Sicht - today's perspective
der Widerstand - resistance
etw. mitbekommen - to be aware of sth.
die Massenmedien - mainstream media
geregelt sein - to be regulated
beteiligt sein - to be involved
persönlich - personally
sich kein Urteil erlauben  - to not pass judgment
etw. nachvollziehen können - to be able to understand sth.
aussehen - to look
jmd. verurteilen - to judge sb.
die Lehre - lesson
sich etw. überlegen - to consider sth.
sich verhalten - to act
wachsam sein - to be on alert
unmoralisch - immoral
der Umgang - way of dealing
einigermaßen - reasonably
die Schuld - blame
die Scham - shame
behaftet sein mit etw. - to be tainted with sth.
dazu führen - to result in
ausgeschlossen sein - to be out of the question
das Gewissen - conscience
die Stolpersteine - stumbling stones (tiny memorials)
der Großteil - main part
die Nachbarschaft - neighbourhood
etw. aufstellen - to set sth. up
der Bruchteil - fraction
etw. schaffen - to achieve sth.
überlegen - superior
weggebracht werden - to be taken away
mitten am Tag - in broad daylight
unmöglich - impossible
schweigen - to remain silent
ansatzmäßig - rudimentary
die Diktatur - dictatorship
teilweise - partly
verhaftet werden - to be arrested
gegenüber - towards
die Regierung - government
verschwinden - to disappear
von einem Tag auf den anderen - from one day to the next
sich verbinden - to merge
gegen etw. aufstehen - to stand up against sth.
unfassbar - unbelievable
etw. dagegen tun - to do something against it
sauer sein - to be angry
ein Gefühl teilen - to share a feeling
die Tendenz - tendency
die Fremdenfeindlichkeit - xenophobia
der Antisemitismus - Anti-Semitism
keineswegs - by no means
abnehmen - to decrease
weggucken - to look away
protestieren - to protest
die Gesellschaft - society
im Prinzip - as a matter of fact
etw. besprechen - to talk about sth.
der Gesichtspunkt - point of view
an einem Punkt - at one point
etw. aufarbeiten - to work through sth.
mit etw. umgehen - to handle sth.
etw. lernen - to learn sth.
man hat nie ausgelernt - you never finish learning
grundsätzlich - basically
vielleicht - maybe
keine Lust haben - to not be in the mood
sich weigern - to refuse
etw. vergessen - to forget sth.
das Gedenken - commemoration
etw. übersehen - to miss sth.
etw. tabuisieren - to make sth. a taboo subject
der Verlierer - loser
der Zweite Weltkrieg - Second World War
ein Thema behandeln - to discuss a subject
die Hippie - Generation - hippie generation
die Bewegung - movement
dafür sorgen - to make sure
die Frage - question
mit etwas umgehen - to deal with something
die Verantwortung - responsibility
die Schuld - guilt
die Verarbeitung - the processing
möglich sein - to be possible
nachdem - after
die Verwaltung - administration
die Entnazifizierung - denazification
die Reintegration - reintegration
beteiligt sein an etw. - to be involved in sth.
weiter beschäftigt sein - to remain employed
das Gefängnis - prison
weiterhin - still
der Arzt - doctor
die Gefahr - danger
stark - strong
bestraft werden - to be punished
die Moral - morale
die Bevölkerung - population
die Sorge - fear
sich erholen - to recover
in eine Falle tappen (ugs.) - to fall into a trap (colloq.)
die Erinnerungskultur - Culture of Remembrance
der Zusammenhang - context
etw. gedenken - to remember sth.
sich verschließen - to shut oneself off
rießig - giant
mitten in - in the middle of
viel Raum einnehmen - to take up a lot of space
froh sein - to be happy
etw. schaffen - to make sth.
das Land - country
etw. vergleichen - to compare sth.
geschehen - to happen
etw. kreieren - to create sth.
etw. hinbekommen - to manage sth.
kollektiv - collectively
erschreckend - frightening
antisemitisch - antisemitic
die Einstellung - attitude
die rassistische Partei - racist party
an Zulauf gewinnen - to increase in popularity
trotz - despite
etw. empfinden - to feel sth.
genervt sein - to be annoyed
die Art - sort
einen Schlussstrich ziehen (ugs.) - to draw a line under the bill (colloq.)
darüber reden - to talk about
die Aussage - statement
zustimmen - to agree
erwähnen - to mention
vergessen - to forget
das kommt darauf an - that depends on
perfide - perfidious
die Vielfalt - diversity
etw. beraubt werden - to be robbed of sth.
ermordet werden - to be murdered
aus unserer Mitte - from our midst
übrig sein - to be left
dankbar sein - to be grateful
übrigens - by the way
die jüdische Gemeinde - Jewish community
sich ändern - to change
zusammen - together
die Kernfrage - main issue
das Tabuthema - taboo subject
unbedingt - necessarily
der Nationalstolz - national pride
die Fahne - flag
etw. anders sehen - to see sth. differently
traurig sein - to be sad
froh sein - to be glad
die nationalistischen Strömungen - nationalistic tendencies
befürchten - to fear
die Menschheit - humanity
der Hass - hatred
das Jahrhundert - century
kämpfen - to fight
das Schlusswort - final word
stattfinden - to take place
teuer - expensive
lapidar - small / unimportant
von etw. berichten - to report on sth.
unterwegs - on the way
der Neujahrsvorsatz - New Year's resolution
sehr zur Freude von jmd. - much to the delight of sb.
die Flugangst - fear of flying
als Erstes - first of all
der ein oder andere - some of you
das Pauschalticket - package ticket
etw. bestimmen - to decide on sth.
innerhalb - within
der Zeitraum - period
die Initiative - initiative
das Bahnfahren - rail travel
obwohl - although
unmöglich  - impossible 
theoretisch - theoretically
überall - everywhere
einsteigen - to get on board
die Reservierung - reservation
sowohl als auch - as well as
verdammte Scheiße (ugs.) - damn it (colloq.)
sich über etw. aufregen - to get upset about sth.
furchtbar - awful
sich überlegen - to consider
normalerweise - normally
in Wirklichkeit - in reality
das Kuhkaff (ugs.) - one-horse town (colloq.)
der schnelle Zug - fast train
eingesetzt werden - to be used
anhalten - to stop
langsam - slow
unterschiedlich - different
das Schienensystem - rail system
das Labyrinth - labyrinth
etw. teilen - to share sth.
doof - stupid
abgesehen davon - apart from that
meiner Meinung nach - from my point of view
die Subventionierung - subsidization
die Steuern - taxes
der Mehrwertsteuersatz - VAT rate / Value Added Tax rate
die Steuern senken - to reduce taxes
endlich - finally
früher - formerly
erscheinen - to come out
umsteigen - to change trains
nirgends - nowhere
buchbar - bookable
außerhalb - outside
jammern - to whine
berechtigt - entitled
etw. ändern - to change sth.
das Gesetz - law
durchgehend - non-stop
zack (ugs.) - there you go (colloq.)
die Morgenroutine - morning routine
kombinieren - to combine
etw. vorspielen - to play sth.
sich geehrt fühlen - to feel honored
die Antwort - answer
manchmal - sometimes
je - ever
in der letzten Zeit - recently
das Vorbild - idol
die Mentalität - mentality
das Verhalten - behavior
von etw. inspiriert werden - to be inspired by sth.
verbringen - to spend
jeden Morgen - every morning
sich etw. wünschen - to wish for sth.
die Abendroutine - evening routine
empfehlen - to recommend
das freut mich - I'm happy about that
deswegen - therefore
besonders - especially
die Uhrzeit - time
meditieren - to meditate
als allererstes - first of all
frühstücken - to have breakfast
der Gedanke - thought
der vorherigen Tag - the day before
um des Schreibens willen - for the sake of writing
darum - therefore
die Sache - thing
etw. durchlesen - to read through sth.
den Kopf leer kriegen - to empty your mind
umschwirren - to buzz around
meistens - most of the time
vor dem Schlafengehen - before bedtime
insbesondere - in particular
das Sachbuch - non-fiction book
danach - afterwards
einschlafen - to fall asleep
gemütlich - comfortably
inspiriert sein - to be inspired by
in dem Sinne - in that sense
berichten - to report
dieses Jahr - this year
regelmäßig - regularly
etw. verkünden - to announce sth.
die Testphase - test phase
direkt - directly
sich verzetteln - get bogged down in sth.
schrecklich - horrible
der Drang - urge
je nachdem - depending on
die Angelegenheit - point
das Wichtige - important things
was ansteht - what's on the agenda
entweder oder - either or
faul - lazy
das Laufband - treadmill
Sport machen - to do sports
allerdings - but
meine Art etw. zu tun - my way of doing sth.
was hältst du davon - how do you feel about this
Zeit für sich selbst nehmen - to take time for oneself
etw. durchtakten (ugs.) - to be fully booked (colloq.)
verschenken - to give away
bestätigen - to confirm
sich verabschieden - to say goodbye
jmd. begrüßen - to greet sb.
die Aufgabe - task
zuhause - at home
das nächste Mal - next time
sprechen - to speak
die Hausaufgabe - homework
einigee - some
alles auf einmal - all at once
der Unterschied - difference
sich fragen - to wonder
das Ganze - whole thing
unendlich - infinite
expandieren - to expand
dadurch - thereby
ständig - permanently
die Vermutung - presumption
existieren - to exist
das Paralleluniversum - parallel universe
miteingeschlossen - included
etw. beschreiben - to describe sth.
endgültig - final
das Beste - best
die Sammlung - collection
neu dazu kommen - to be added
das Universum - universe
die Natur - nature
die Wahrheit - truth
der Sinn - meaning
diskutieren - to discuss
interessanterweise - interestingly
offensichtlich - obviously
der Begriff - term
das Gefühl - feeling
jmd. in dem Glauben lassen - to lead sb. to believe
der Vorschlag - suggestion
gespannt sein - to be curious
am passendsten - most fitting
etw. kennenlernen - to get to know sth.
die Mühe - effort
die Stimme - voice
der Knopf - button
etw. hochladen - to upload sth.
prima - great
der Freiwilligendienst - voluntary service
im gleichen Jahr - in the same year
dort - there
herauskommen  - to be released
ähnlich wie - similar to
der Freiwillige - volunteer
zeigen - to show
das Leben - life
arbeiten - to work
sich verlieben - to fall in love
ziemlich - quite
entdecken - to discover
kostenlos - free of charge
verfügbar - available
der Untertitel - subtitle
die Übung - exercise
der Einblick - insight
die Empfehlung - recommendation
vor Kurzem - most recently
der Feiertag - holiday
vorlesen - to read aloud
etw. positiv aufnehmen - to take sth. positively
im Ausland - abroad
unter anderem - among other things
der Abschnitt - part
jmd. etw. vorwerfen - to accuse sb. of sth.
normalisieren - to normalize
die Sympathie - sympathy
das Mitleid - pity
schaffen - to create
wütend - angry
etw. unterstützen - to support sth.
manche von ihnen - some of them
die Veränderung - change
mystifizieren - to mystify
die Sicht - view
darstellen - to show
nahbar - approachable
das Opfer - victim
aller Zeiten - of all times
abgesehen von - aside from
den jeder kennt - which everyone knows
der bekannteste Song - most famous song
mitsingen - to sing along
hören - to listen
schreien - to shout
ausnahmsweise - as an exception
sich verhaspeln - to get into a muddle
navigieren - to navigate
der Erfolg - success
etw. berichten - to report sth.
besagte Reise - said trip
ungeplant - unplanned
als nächstes - next
jmd. persönlich kennen lernen - to get to know someone personally