aufnehmen - to record
gut drauf sein - to be in a good mood
überdreht sein - to be hyper
die Arbeit - work
spät - late
früh - early
in letzter Zeit - these days
ins Bett gehen - to go to bed
einschlafen - to fall asleep
jmd. bewegen - to affect sb.
arbeiten - to work
die Leute - people
schwer - difficult
etw. besprechen - to discuss sth.
zeigen - to show
leichtsinnig - frivolously
der Hörer - listener
schicken - to send
jmd. erreichen - to reach sb.
kennen - to know
ja klar - of course
Oder nicht? - Isn't it?
das Bild - picture
beschreiben - to describe
die Nachricht - message
das Hemd - shirt
die Stange - rod
dazugehörig - corresponding
bügeln - to iron
älter - older
zuhören - to listen
das Handy - cell phone
glücklich - blissful
begeistert - enthusiastic
das Fahren - driving
die Ampel - traffic light
noch eine - another
auf etw. bestehen - to insist on sth.
die Aufgabe - task
der Arbeitsplatz - workplace
die Fabrik - factory
das Plastikteil - plastic part
morgens - in the morning
nachmittags - in the afternoon
die Chefin - boss
lehrreich - educational
die Arbeitszeit - working time
ausfüllen - to fill
spannend - exciting
unaufgeregt - dispassionate
entspannt - relaxed
das Mitglied - member
sich wünschen - to ask for
krass - crazy
die Umfrage - survey
der Unterstützer - supporter
die Rückmeldung - feedback
verblüfft sein - to be astonished
sich mit etw. beschäftigen - to engage with sth.
die Politik - politics
inwiefern - in what way
die Partei - political party
der Alltag - everyday life
nerven - to annoy
wichtig - important
der Bürger - citizen
aufhören - to stop
der Großteil - majority
sterben - to die
der Wille - the will
das Volk - the people
herrschen - to rule
die Minderheit - minority
der Grund - reason
bedrückend - depressing
wählen - to vote
die Wahl - election
jmd. erwischen - to catch sb.
der feste Wohnsitz - permanent address
zu etw. stehen - to be committed to sth.
sich entscheiden - to decide
links - on the left
erklären - to explain
das Grundsätzliche - fundamentally
das Mehrparteiensystem - multiparty system
sich auszeichnet - to be notable
sich unterscheiden - to differ
das Verhältnis - ratio
die Wahlmöglichkeit - choice
vorstellen - to introduce
der Bundestag - German federal parliament
beziehungsweise - respectively
der Landtag - German state parliament
vertreten sein - to be represented
zur Wahl stehen - to stand for election
sich angucken - to have a look at
das Wahlsystem - electoral system
unmöglich - impossible
eine dritte Partei - a third party
nicht gefallen - to do not like
der Nachteil - disadvantage
das Zweiparteiensystem - two-party system
die Auswahl - choice
die Ausrichtung - positioning
innerparteilich - within the party
die Vorauswahl - pre-selection
der Wechselwähler - swing voter
immer - always
ausgeschlossen sein - to be out of the question
taktieren - to use tactics
festgefahren - gridlocked
das Jahrzehnt - decade
dazukommen - to be added
an der Macht sein - to be in power
verlieren - to lose
Bewegung - activity
der Zweite Weltkrieg - Second World War
die Diktatur - dictatorship
verwandeln - to transform
die Angst - fear
die Gefahr - danger
einführen - to introduce
das Wahlrecht - electoral law
etw. ausschließen - to preclude sth.
die Zersplitterung - fragmentation
die Fünfprozenthürde - five-percent hurdle
die Kleinpartei - small party
gewinnen - to win
gleichzeitig - at the same time
die Landesliste - regional list of candidates for election to the Federal Parliament
fördern - to promote
prozentual - proportionally
gezielt - deliberately
das Direktmandat - direct mandate
die Erststimme - first vote
die Zweitstimme - second vote
im Schnelldurchlauf - rapidly
die Volkspartei - people' s party
zusammengenommen - taken together
die Stimme - vote
mehr - more
die allermeisten - vast majority
die Macht - power
gewinnen - to gain
konservativ - conservative
liberaler - more liberal
über die Jahre - over the years
die Figur - character
in der Mitte - in the center
Vertrauen genießen - to be trusted
von allen Seiten - from all sides
ursprünglich - originally
die Arbeiterpartei - workers' party
der Großteil der Zeit - most of the time
die große Koalition - grand coalition
das Mischmasch - hotchpotch
mit wenig Profil - lacking profile
jmd. vertreten - to represent sb.
größtmöglich - greatest possible
die Veränderung - change
spekulieren - to speculate
etw. wahrnehmen - to notice sth.
der Fortschritt - progress
etw. rückgängig machen - to undo sth.
scheiße sein (ugs.) - to suck (colloq.)
sich abgewechseln - to take turns
bröckeln - to crumble
schwächer werden - to weaken
keinen Bock auf etw. haben (ugs.) - to be unhappy with sth. (colloq.)
der Einheitsbrei - uniform mush
das Mischmasch - hodgepodge
sich gegenüberstehen - to oppose each other
regieren - to govern
zusammenarbeiten - to work together
gut klappen - to work out well
gelangweilt sein - to be bored
das Ergebnis - result
aus beiden Sichten - from both points of view
nicht weit genug gehen - to not go far enough
zugunsten - in favor of
die Grünen - Green Party
die Anti-Atom-Bewegung - anti-nuclear movement
der Umweltschutz - environmental protection
das Hauptthema - main topic
der Kampf - fight
beide Linien - both segments
das konservative Lager - conservative camp
sich wandeln - to transform
der Einfluss - influence
etw. merken - to notice sth.
absurde Züge annehmen - to take on absurd forms
der Klimaschutz - climate protection
bedrohen - to threaten
die Schwesterpartei - sister party
anfangen - to start
das Thema zieht (ugs.) - the issue draws votes (colloq.)
von heute auf morgen - overnight
der Vorschlag - proposal
die Energiewende - energy system transformation
beschützen - to protect
das Gegenteil - opposite
die Sonderstellung - special status
Bayern - Bavaria
das Bundesland - federal state
nicht … genug - not ... enough
zusammenfassen - to summarize
ersetzen - to replace
der Streit - dispute
die Flüchtlingspolitik - refugee policies
sich spalten - to split
auf öffentlicher Bühne - in public
sich bekriegen - to fight each other
die Regierung - political administration
zerbrechen - to break apart
streiten - to argue
die Spaltung - separation
verwechseln - to mistake
die Klientelpolitik - clientele politics
der Unternehmer - business (owner)
die Führungspersönlichkeit - leadership figure
beteiligt sein - to participate
die Persönlichkeit - personality
die Randerscheinung - marginal phenomenon
der Bundestag - German parliament
herausfliegen - to get kicked out
regulieren - to regulate
der Markt - the market
sich selbst regeln - to regulate itself
entstehen - to emerge
vorüber sein - to be over
sich wandeln - to change
etw. vertreten - to advocate sth.
die Meinung - opinion
die Landesregierung - state government
die Bundesländer-Ebene - federal state level
anhaften - to be associated with
dem gegenüber stehen - to stand on the opposite side
eurokritisch - Europe-critical
der Gründer - founder
der Widerspruch - contradiction
ausscheiden - to withdraw
zurücktreten - to resign
der Einfluss - Influence
die rechtsextremen Ansichten - right-wing extremist views
der Holocaustleugner - Holocaust denier
stolz - proud
die Leistung - achievement
das Holocaustmahnmal - Holocaust Memorial
nennen - to call
Mahnmal der Schande - Memorial of Disgrace
dulden - to condone
fördern - to encourage
rechtsextrem - extreme right-wing
die Verfassung - constitution
etw. in Frage stellen - to question sth.
die Pressefreiheit - freedom of the press
der Grundpfeiler - cornerstone
berichten - to report
geschützt sein - to be protected
jmd. angreifen - to assault sb.
die Presse - the press
aufmuntern - to encourage
das Verhalten - behavior
gefährlich - dangerous
auf ein Level stellen - to put on the same level
richtig - true
der Unterschied - difference
erlaubt sein - to be allowed
Grenzen überschreiten - cross boundaries
die weiße Rasse - the white race
in Gefahr sein - to be in jeopardy
verschwörungstheoretisch - conspiracy-theoretical
der Ausländer - foreigner
die Alarmglocken - alarm bells (colloq.)
benutzen - to use
die Umvolkung (rassistischer Begriff) - ethnic replacement (racist term)
in ihrem Sinne - according to them
das Recht - the right
die Verschwörungstheorie - conspiracy theory
die Gewalttat - act of violence
zunehmen - to increase
angreifen - to assault
der Bürgermeister - mayor
das Gewaltpotential - potential for violence
unbekannt - unknown
bekannt - well-known
der Fall - case
Hass schüren - to incite hatred
zu etw. aufrufen - to call for sth.
Blut an den Händen kleben (ugs.) - there is blood on sb's hands (colloq.)
der Flüchtling - refugee
der Zusammenhang - connection
zu weit führen - to lead too far
etw. regt jmd. auf - sth. upsets sb.
ein Versprechen brechen - to break a promise
der normale Sachverstand - normal intelligence
die Mitmenschen - fellow humans
neutral bleiben - to remain neutral
die Geschichte - history
der Nationalsozialismus - National Socialism
vorstellen - to imagine
die Vorstellungskraft - imagination
das Verbrechen - crime
das Unrecht - injustice
das Unheil - doom
kaum vorstellbar - barely imaginable
der Zuspruch - approval
das Gedankengut - body of thought
sich beteiligen - to participate
die Kommunalwahlen - local elections
die Landtagswahlen - state elections
auf Landesebene - at state level
die Bundestagswahl - Bundestag election
der Kanzler - chancellor
die Europawahl - European elections
der Vertreter - representative
reinkommen - to get in
hervorheben - to highlight
die Satirepartei - satirical party
gründen - to found
die Abkürzung - abbreviation
der Rechtsstaat - rule of law
der Tierschutz - animal welfare
die Elitenförderung - promotion of the elite
die basisdemokratische Initiative - grassroots democratic initiative
der Witz - joke
das Jubiläum - anniversary
auf lustige Weise - humorously
sich mit etw. beschäftigen - to deal with sth.
der Wiederaufbau - rebuilding
die Mauer - Berlin Wall
abstrus - bizarre
die Forderung - demand
ernst - serious
mit satirischen Mitteln - by satirical means
der Missstand - wrong-doing
auf etw. hinweisen - to point sth. out
auf lustige Art und Weise - humorously
die Rede - speech
die Splitterpartei - splinter party
erwähnen - to mention
die Bundeskanzlerin - Federal Chancellor
der Bundespräsident - Federal President
die Weltpolitik - world politics
verfolgen - to follow
die höchste Person - highest person
sich einschalten - to weigh in
keine Lust haben - to have no desire
eine Regierung bilden - to form a government
die Bundestagswahl - Bundestag elections
ablosen (ugs.) - to really be losing (colloq.)
Stimmen verlieren - to lose votes
aktuell - current
vermittelnd - mediating
die Neuwahl - new elections
die Mehrheit - majority
ehemalig - former
die Parteimitgliedschaft - party membership
ruhen - to be dormant
im Amt sein - to hold office
dauerhaft - permanently
die Stellung - status
mächtig - powerful
unpopulär - unpopular
für etw. bekannt sein - to be known for sth.
auf etw. reagieren - to react to sth.
das Manko - shortcoming
kritisiert werden - to be the subject of criticism
ankündigen - to announce
antreten - to run for office
die jetzige - the current
sich zurückhalten - to be reserved
die Sicht - perspective
einbringen - to add
das Gefühl - feeling
einerseits - on the one hand
die Vorsitzende - chairwoman
meiner Meinung nach - in my opinion
die Zukunft - future
Haltung beziehen - to take a stance
die Homo-Ehe - gay marriage
gleichgeschlechtliche Paare - same-sex couples
heiraten - to get married
der Ersatz - substitute
die eingetragene Lebensgemeinschaft - civil union
dagegen sein - to be against it
die Ehe - marriage
die Stimmung kippt - the mood shifts
dafür sein - to be in favor of it
umkippen (ugs.) - to flip (colloq.)
das Zeichen - mark
charakterlos - unprincipled
mit der Welle gehen - to go with the tide
verhasst sein - to be hated
etw. vertreten - to represent sth.
öffentlich - publicly
nötig - necessary
die Flüchtlingskrise - refugee crisis
die moralische Pflicht - moral duty
aufnehmen - to take in
froh sein - to be glad
mit Verstand - intelligently
mit Empathie - empathetically
insofern - to that extent
seine Meinung ändern - to change one's mind
jmd. aufnehmen - to take sb. in
die Stimmung - mood
das Gefängnis - prison
unmenschliche Umstände - inhumane circumstances
das Kriegsgebiet - war zone
fliehen - to flee
die gleichgeschlechtliche Ehe - same-sex marriage
die Atomkraft - nuclear power
ur-demokratisch - deeply democratic
die Bevölkerung - population
etw. aufnehmen - to absorb sth.
schneller - faster
die Menschenrechte - human rights
etw. anerkennen - to acknowledge sth.
etw. aussitzen - to sit sth. out
alle an einen Tisch bekommen (ugs.) - to get everyone around one table (colloq.)
der Hass - hatred
das politische Lager - political camp
unversöhnlich - irreconcilable
etw. schaffen - to manage sth.
jmd. wählen - to vote for sb.
das Spiel - game
die Entscheidung - decision
schlecht funktionierend - working badly
vorangehen - to make progress
in letzter Zeit - lately
häufig - frequently
der Meinung sein, dass - to be of the opinion that
die Staatsform - form of government
eine Stimme haben - to have a voice
der Gesichtspunkt - aspect
unter Umständen - possibly
die Entwicklung - development
eintreten - to come into effect
umdrehen - to reverse
spannend - fascinating
ein Gesetz verabschieden - to pass a law
etw. über die Lippen bringen (ugs.) - to be able to say sth. (colloq.)
im Ernsten - seriously
aus moralischen Gründen - on moral grounds
die Gesellschaft - society
umstrukturieren - reorganize
der Klimawandel - climate change
aufhalten - to stop
an etw. zugrunde gehen - to perish from sth.
sich für etw. entscheiden - to opt for sth.
die Hoffnung - hope
der Druck - pressure
die Mittel - means
etw. erreichen - to achieve sth.
verlockend - tempting
die Vorstellung - idea
andererseits - on the other hand
langfristig - in the long run
zu nichts Gutem führen - to lead to nothing good
machtbesessen - power-obsessed
etw. an sich reißen - to seize sth.
korrumpiert - corrupted
am Anfang - in the beginning
die Prinzipien - principles
die Zusammenarbeit - collaboration
für wen? - for whom?
etw. heißt nicht, dass - sth. does not mean that
etw. muss sein (ugs.) - sth. is a must (colloq.)
berühmt - famous
im Rahmen - in the context of
etw. verlinken - to link to sth.
die Pressekonferenz - press conference
bedeuten - to mean
etw. hinkriegen - to pull sth. off
etw. meistern - to handle sth.
schneiden - to edit
der Ausdruck - expression
alltäglich - everyday
die Aufmunterung - encouragement
stark - strong
die Wirtschaft - economy
Recht haben - to be right
zur Debatte stehen - to be up for debate
sich positionieren - to take a stand
der Zusammenhang - context
überspringen - to skip
die Empfehlung - recommendation
die Folge - episode
rechtzeitig schaffen - to make it on time
der Zug - train
der eigentliche Grund - the real reason
etw. verheimlichen - to hide sth.
die Einkaufsstadt - city of shopping
die Flucht - fleeing
die Schönheit - beauty
passend dazu - fitting
etw. vorstellen - to present sth.
die Form - shape
das Muster - pattern
etw. wahrnehmen - to perceive sth.
das Auge - eye
die Erziehung - upbringing
an etw. gewöhnt sein - to be used to sth.
der Kunstmarmor - artificial marble
hässlich - ugly
aufwachsen - to grow up
empfinden - to perceive
darauf ankommen - to depend
trotzdem - anyway
empfehlen - to recommend
passieren - to happen
das Thema - topic
nicht zwangsläufig - not necessarily
sich mit etw. beschäftigen - to be concerned with sth.
jmd. folgen können - to be able to understand sb.
verstehen - to comprehend
sich für etw. interessieren - to be interested in sth.
einfallen - to come to mind
die Zerstörung - destruction
etw. äußern - to express sth.
sich nennen - to call oneself
mehrdeutig - ambiguous
meinen - to mean
sich selbst zerstören - to be self-destructive
normalerweise - normally
im Hintergrund - in the background
am Herzen liegen - to be dear to sb.'s heart
wählen - to vote for
unglaublich - incredibly
viral gehen - to go viral
etw. thematisieren - to address sth.
die Kolumne - column
berühmt sein - to be famous
auf dem Titel - on the cover
die Zeitung - newspaper
etw. recherchieren - to do research on sth.
die Quelle - source
der Beleg - evidence
teilweise - in part
populistisch - populist
etw. überspitzt darstellen - to oversimplify sth.
journalistischen Standards entsprechen - to meet journalistic standards
die Zielgruppe - target audience
jmd. zugute halten - to credit sb.
jmd. dazu bringen - to get sb. to do sth.
unerwartet - unexpected
just in dieser Minute - right this minute
das Lied - song
der Ohrwurm - a catchy tune
im Kopf - in one's head
der Schauspieler - actor
der Clubbetreiber - club owner
sich künstlerisch betätigen - to be artistically involved
der Refrain - chorus
witzig - funny
Schluss machen - to break up
die Beziehung - relationship
beenden - to end
die Freundin - girlfriend
der Trennungsgrund - reason for splitting up
sich mit etw. auseinandersetzen - to grapple with sth.
jmd. ernst nehmen - to take sb. seriously
die Ansicht - view
die Spannung - tension
sich unterhalten - to converse
sich treffen - to meet
sich befreunden - to befriend sb.
die Einstellung - attitude
die Vorstellung - conception
überzeugend - persuasively
für etw. einstehen - to stand up for sth.
das Zeitalter - the age (of)
umgeben sein - to be surrounded
gesund - healthy
sich trennen - to split up
sich gegenseitig beeinflussen - to influence each other
im Anbetracht - in view of
die Eile - hurry
grundlegend - fundamental
das Lebensziel - life goal
überleben - to survive
die künstliche Intelligenz - artificial intelligence
besiegen - to conquer
geben - to give
nehmen - to take
was etw. betrifft - with regard to sth.
das Ziel - goal
zwischenmenschlich - interpersonal
der Bereich - area
einfordern - to demand
glücklich - happy
die Zusammenfassung - summary
die Stoppuhr - stopwatch
auf etw. ausgerichtet sein - to be geared towards sth.
etw. merken - to realize sth.
grundsätzlich - fundamentally
Dialog herstellen - to create dialog
etw. ermöglichen - to make sth. possible
über Ländergrenzen hinweg - across borders
soziale Grenzen - social boundaries
der Vortrag - lecture
der Austausch - exchange
sich verstehen - to understand each other
überrascht sein - to be surprised
sich zurückhalten - to withhold
sich aufsparen - to save for
zum Glück - fortunately
eruieren - to find out
diskutieren - to debate
die Aufarbeitung - reviewing
der Wunsch - wish
langweilig - dull
die Episode - episode
wie jmd. etw. findet - how sb. likes sth.
auf dem Herzen haben - to have on one's mind
klingt gut - sounds good
reinhauen müssen (ugs.) - to have to get going (colloq.)
bis bald - see you soon