immer - always
regelmäßig - on a regular basis
unterschiedlich - different
die Stadt - town
ruhig - calm
gemütlich - comfortable
der Einstieg - introduction
mit etw. loslegen - to get started with sth.
eigentlich - actually
die Erfindung - invention
jmd. etw. anbieten - to offer sth. to someone
die Übersetzung - translation
etw. verfolgen - to follow sth.
die Lösung - solution
zusätzlich - additionally
ab sofort - starting immediately
rückwirkend - retrospectively
etw. (her)runterladen - to download sth.
das Handy - cell phone
quasi - basically
wechseln - to change
haargenau - precisely
das Kapitel - chapter
etw. möglich machen - to make sth. possible
der Fuchs - fox
sich etw. anschauen - to take a look at sth.
smart - smart (clever)
sich nennen - to call oneself
strikt - strictly
das Geschlecht - the gender
sich mit etw. identifizieren - to identify with sth.
deswegen - therefore
etw. bevorzugen - to prefer sth.
der Gast - guest
jmd. antworten - to reply to sb.
nicht so richtig - not really
häufiger - more frequently
etw. benutzen - to use sth.
manche - some
etw. einsetzen - to put sth. in
am liebsten - preferably
alltagstauglich - compatible with everyday life
Es scheint so, als … - It seems that …
sich auf etw. einigen - to agree on sth.
krass (ugs.) - glaring, here: crazy (colloq.)
etw. dauert seine Zeit - sth. takes some time
mal wieder - once again
toll - great
die S-Bahn - suburban train
der Kopfhörer - headphone
liebe Grüße - best wishes
mit dem Hund spazieren gehen - to walk the dog
sich etw. durchlesen - to read through sth.
die Vorbereitung - preparation
gelangweilt - bored
auf etw. warten - to wait for sth.
wahnsinnig (ugs.) - incredibly (colloq.)
das Autofahren - car driving
etw. genießen - to enjoy sth.
vielen Dank - thank you very much
tätig sein - to work
Oliven ernten - to harvest olives
überwältigt - overwhelmed
meckern - to complain
wenig - few
null - zero
einschlagen wie eine Bombe (ugs.) - to have a big impact (colloq.) 
süß - cute
Weihnachten - Christmas
Silvester - New Year's Eve
der Austauschschüler - exchange student
etw. kennenlernen - to get to know sth.
der Geburtstag - birthday
geil - awesome
über etw. reden - to talk about sth.
Stimmt! - That's right!
verwirrt sein - to be confused
der Sinn des Lebens - the meaning of life
reisen - to travel
mit weniger glücklich sein - to be happy with less
mit etw. zu tun haben - to be related to sth.
sich mit etw. beschäftigen - to occupy oneself with sth.
der Alltag - everyday life
das Essen - food
entwickelt - developed
die Gesellschaft - society
die Erkrankung - disease
bekloppt (ugs.) - crazy (colloq.)
bekloppt - crazy
eine Idee entwickeln - to develop an idea
ab und an  - from time to time 
abschalten - to switch off
Menschen besuchen - to visit people
ursprünglich - originally
durchgetaktet - perfectly timed
durchgeplant - fully planned
die Leistungsgesellschaft - achievement-oriented society
etw. verhunzen - to ruin sth.
einzigartig - unique
außerdem - additionally
unterwegs sein - to be on the way
vor kurzem - recently
jmd. komisch anschauen - to look at sb. strangely
etw. bemerken - to notice sth.
lächeln - to smile
lachen - to laugh
verrückt - crazy
die Unterhaltung - entertainment
die Mühe - effort
wunderschön - beautiful
total - here: really
jmd. etw. passieren - to happen to sb.
die U-Bahn - subway
auffällig - conspicuous
alle möglichen Dinge - all kinds of things
für etw. bekannt sein - to be known for sth.
starren - to stare 
die Hemmung - inhibition
höflich - politely
vielleicht - maybe
auf einmal - all of a sudden
sich etw. fragen - to wonder about sth.
für etw. bereit sein - to be ready for sth.
Los geht's! - Let's go!
noch etw. sagen wollen - to want to say sth. in addition
ein lang gehegter Traum - a long-held dream
ziemlich viele - quite a lot of
am Ende - in the end
möglich sein - to be possible
die Niete - loser
jmd. behilflich sein - to help sb. with sth.
Grenzen haben - to have limits
Spaß an etw. haben - to enjoy sth.
das ist schade - that's a pity
einen Film schneiden - to edit a film
etw. bedienen - to operate sth.
aus Spaß - for fun
ein Mittel zum Zweck - a means to an end
an sich - in itself
an etw. Freude haben - to enjoy sth.
wie angekündigt - as announced
jmd. enttäuschen - to disappoint sb.
gut in etw. sein - to be good at sth.
langweilig - boring
Es kann sein, dass … - It might be that …
jmd. etw. schwer fallen - to have a hard time with sth.
im gewissen Sinne - in a certain way
im Gegensatz zu - in contrast to
in etw. total aufgehen - to be completely immersed in sth.
in Berührung kommen - to come in contact
der Akku - battery
zocken - to gamble
von etw. besessen sein - to be obsessed with sth.
der Haushalt - household
die Ausstattung - equipment
am meisten - most of all
sich in etw. reinfuchsen - to teach oneself sth.
spät sein - to be late
etw. dokumentieren - to record sth.
etw. mit nach Hause bringen - to bring sth. home
das Betriebssystem - operating system
die Festplatte - hard disk
sich erinnern - to remember
damals - at that time
der Unterschied - difference
Einzug in etw. halten - to arrive 
das Leben verändern - to change one's life
eine Geschichte schreiben - to write a story
stundenlang - for hours
der beste Freund - best friend
die Grundschulklasse - elementary school class
das allererste - the very first
abschießen - to shoot
verboten - illegal
das Hakenkreuz - swastika
die Erziehung - education
die Empfehlung - recommendation
das achtjährige Kind - eight-year-old child
ein Passwort setzen - to set a password
etw. entsperren - to unlock sth.
eine neue Seite von jmd. kennen lernen - to get to know sb. from a different angle
das Sekretariat - secretary's office
die Seite - page
das Querformat - landscape format
etw. ausdrucken - to print out sth.
etw. rausfinden - to find out about sth.
Stress geben - to cause problems
etwas anstellen - to do something bad 
in Wirklichkeit - as a matter of fact
der Streber - teacher's pet
die Kindheit - childhood
mit etw. zusammenhängen - to be related to sth.
jemand - somebody
und so weiter - and so on
inhärent - included
etw. kaufen - to buy sth.
Einfach nur, weil … - Just because …
die Welt besser oder schlechter machen - to make the world a better place or a worse place
im Prinzip - in principle
fremd - foreign
das Straßenzeichen - road sign
etw. buchen - to book sth.
die Unterkunft - accommodation
ins Internet gehen - to go online
der Aufwand - effort
etw. bringt Menschen näher - sth. brings people closer together
flüchten - to escape
etw. zurücklassen - to leave sth. behind
einmal im Monat - once a month
der Brief - letter
Kontakt haben - to be in touch
die nahe Begegnung - close encounter
die Berührung - (physical) touch
etw. nahe kommen - to approach sth.
im gleichen Raum - in the same room
Zeit miteinander verbringen - to spend time together
Das ist ein guter Punkt! - That's a good point!
sich einpendeln - to level off
eine Prognose abgeben - to make a forecast
heikel - delicate
sich eine Frage stellen - to ask oneself a question
die Anzahl - the amount
begrenzt - limited
die Grenze erreichen - to reach the limit
überfordert - overwhelmed
spätestens - at the latest
im Großen und Ganzen - on the whole
einig - agreed
die Bereicherung - enrichment
etw. hinzufügen - to add sth.
die Firma - company
unglaublich - incredibly
im Grunde - basically
das Fernsehen - television
sich eine Möglichkeit ergeben - to arise an opportunity
Potenzial nutzen - to use potential
verpuffen lassen - to fizzle out
Kommt darauf an. - It depends.
der Schriftsteller - author
komisch - strangely
jmd. etw. vorwerfen - to blame sb. for sth.
die Ausrede - excuse
Was weiß ich? - What do I know?
etw. wirklich wollen - to be serious about sth.
absolut - absolutely
etw. veröffentlichen - to make sth. public
berühmt - famous
der Plattenvertrag - record deal
das Unternehmen - company
ohne etw. gar nicht gehen - to be impossible without sth.
die Karriere - career
etw. erreichen - to achieve sth.
Regeln aufbrechen - to break the rules
Regeln folgen - to follow the rules
das Verlagshaus - publishing house
Macht einbüßen - to lose power
jammern - to moan
etw. reinbringen - to drop sth. in
Lieblings… - favorite
etw. besitzen - to own sth.
sozusagen - so to speak
Uff! (ugs.) - Phew! (colloq.)
abwegig - absurd
die Emotion - emotion
die Drohne - drone
unvorstellbar - incredible
durch die Luft fliegen - to fly through the air
überhaupt - anyway
erlaubt sein - to be legal
die Zukunft - the future
das Geld - money
Nicht mehr lange - Not for much longer
das Hochhaus - skyscraper
öffentlich - publicly
das Gesetz - law
studieren - to study
plötzlich - suddenly
die Aufnahme - (photo or video) shot
die Weltreise - world trip
von etw. ausgehen  - to expect sth. 
das Unglück - catastrophe
etw. lahm legen - bring sth. to a standstill
sich etw. leisten - to afford sth.
etw. reglementieren - to regulate sth.
nützlich - useful
die Ruhe - silence
der Sonnenuntergang - sunset
die Landschaft - the landscape
anstrengend - exhausting
schwirren - to buzz
furchtbar - terrible
sich bei jmd. entschuldigen - to apologize to someone
jmd. etw. antun - to harm sb.
hassen - to hate
zwangsläufig - necessarily
der goldene Käfig - the golden cage
aus dem Jahr 2018 - from the year 2018
das Ärgernis - nuisance
ohne Ende - never-ending
zur Genüge - more than enough
Leid beklagen - to complain about problems
teuer - expensive
ständig - constantly
abstürzen - to crash
heiß werden - to heat up
die Tastatur - keyboard
tippen - early
doppelt - to suffer with sb.
nebeneinander sitzen - the story
wortwörtlich - to install sth.
Das ist doch nicht normal! - for several years now
früh - expensive
mit jemandem mitleiden - constantly
die Geschichte - to crash
etw. verbauen - to heat up
seit Jahren - keyboard
to type - unique
twice - 
to sit next to each other - 
literally - 
That' s not normal! - 
der Einzelfall - individual case
mittlerweile - in the meantime
die Blase - bubble
in etw. stecken - to be in sth.
etw. herausbringen - to launch sth.
einen Fehler zugeben - to admit a mistake
das Bewährte - the tried and trusted
leiden - to suffer
die Leistung - achievement
sich auf etw. freuen - to look forward to sth.
sich vergreifen - to make a wrong choice
sich über etw. aufregen - to get upset about sth.
aus Frust - out of frustration
die Krise kriegen - to freak out 
der Fingernagel - fingernail
etw. reinigen - to clean sth.
verstopft sein - to be blocked up
wütend - angry
sich abreagieren - to work off sth. 
etw. ansprechen - to address sth.
jmd. zutexten - to go on and on at sb.
das eine oder andere Mal - from time to time
predigen - to preach
kurz machen - to make it short
jmd. um etw. bitten - to ask sb. for sth.
sich Zeit nehmen - to take one's time
in Flammen aufgehen - to burst into flames
etw. sichern - to save sth.
der Ort - place
ehrlich gesagt - to be honest
referieren - to give a speech
etw. am Herzen liegen - to be dear to one's heart
der Impuls - stimulus
der Sicherheitsbeauftragte - safety officer
selbst ernannt - self-proclaimed
klein, aber fein (ugs.) - small but sweet (colloq.)
die Vergangenheit - the past
schlampig - sloppily
mit etw. umgehen - to handle sth.
die Sicherheit - safety
der Rahmen - setting
der Privatvortrag - private lecture
sich um etw. kümmern - to look after sth.
amüsant - funny
der Austausch - exchange
etw. verdeutlichen - to clarify sth.
etw. verlieren - to lose sth.
ehemalig - former
der Krankenwagen - ambulance
in Ohnmacht fallen - to faint
die Doktorarbeit - PhD thesis
der Rotwein - red wine
etw. zerstören - to destroy sth.
Oh Gott! - Oh my God!
unnötig - unnecessary
mit jmd. Mitleid haben - to feel sorry for sb.
sich herumsprechen - to get around
mit etw. zusammen hängen - to be associated with sth.
keinen Bock mehr haben - to be fed up
vertrauen - to trust
komplett - completely
etw. verschlüsseln - to encrypt sth.
etw. ablegen - to store sth.
trotzdem - nevertheless
der Spruch - the saying
ausgefuchst - shrewd
etw. nachgucken - to look sth. up
erfahren - experienced
trickreich - cunning
der Verkäufer - salesperson
schlau - smart
was Besonderes - something special
gewitzt - shrewd
pfiffig - sharp
blitzgescheit - brilliant
klug - clever
Das ist ganz schön ausgefuchst! - That's pretty clever!
die Vorgabe - guideline
Kommen wir zurück zu … - Let's get back to...
etw. kundtun - to make sth. known
der Anführungsstrich - quotation mark
einfach - easy
jmd. etw. empfehlen - to recommend sth. to sb.
etw. speichern - to save sth.
sich etw. merken - to memorize sth.
stark - strong
zufällig - random
sich anmelden - to sign up
das Fragezeichen - question mark
etw. enthalten - to contain sth.
nicht mehr richtig ticken (ugs.) - to be crazy (colloq.)
jmd. zu etw. zwingen - to force sb. to do sth.
unsicher - unsafe
blöd - stupid
etw. ändern - to make changes to sth.
vierstellig - four-figure
selten - rare
ab und zu - from time to time
jmd. zu etw. aufrufen - to appeal to sb. for sth.
jmd. etw. erlauben - to allow sb. sth.
wählen - to choose
ungefähr - approximately
mit Sicherheit - for sure
die Zeichenlänge - character length
einen Account einrichten - to set up an account
sich etw. ausdenken - to make sth. up
sich aufregen - to get upset
sich beschweren - to complain
der Neujahrsvorsatz - New Year's resolution
folgendermaßen - as follows
feiern - to celebrate
etw. gemütlich angehen lassen - to take sth. easy
im Bett verbringen - to stay in bed
wunderschön - wonderful
sich Ruhe gönnen - to allow oneself some rest
der freie Tag - day off
das Wochenende - weekend
etw. durchgehen - to go through sth.
das Ziel - objective
etw. schaffen - to manage sth.
wenigstens - at least
jmd. beeindrucken - to impress sb.
anderswo - elsewhere
allein - alone
das Flugzeug - airplane
etw. abgeben - to hand sth. in
etw. anfangen - to start sth.
das Fahrrad - bicycle
genug sein - to be enough
das alltägliche Leben - everyday life
keinen Plan haben - to have no idea
die Angst - fear
wahnsinnig - really
der Vorsatz - resolution
etw. merken - to realise sth.
alleine sein - to be alone
der Zug - train
Angst vor etw. haben - to be afraid of sth.
alleine leben - to live alone
selten - rarely
mit jmd. zusammen sein - to be with sb.
ausziehen - to move out
die Eltern - parents
etw. gewohnt sein - to be used to sth.
bei jmd. übernachten - stay overnight with sb.
der Besuch - the visit
sich seiner Angst stellen - to face one's fear
sich etw. versprechen - to expect sth.
der Druck - pressure
die Fahrradtour - bicycle tour
kalt - cold
mit dem Zug durch Europa - across Europe by train
recherchieren - to do research
die Strecke - the route
etw. überbrücken - to get through sth.
unterwegs sein - to be on the road 
unbedingt - at any rate
etw. beeinflussen - to have an impact on sth.
das Segelboot - sailboat
jmd. etw. klar sein - to be obvious to sb.
fliegen - to fly
abgesehen von - besides
umweltbedingt - due to the environment
das Abenteuer - adventure
die Zugfahrt - train ride
länger dauern - to take longer
etw. erleben - to experience sth.
sich etw. teilen - to share sth.
gleichzeitig - at the same time
etw. nicht missen wollen - not wanting to miss something
Russland - Russia
buchen - to book
die Stadt - city
demnächst - soon
vorbei kommen - to pass by
die Schweiz - Switzerland
sich auf etw. vorbereiten - to prepare for sth.
die Aktivität - activity
Zeit aufwenden - to take time
Aufnahme - recording
Zeit mit etw. verbringen - to spend time on sth.
kostenlos - for free
auf den ersten Blick - at first sight
einrichten - to set up
etw. vergeben - to award sth.
das Gerät - device
organisiert - organized
etw. empfehlen - to recommend sth.
natürlich - of course
sich ein Ziel setzen - to set a goal
was auch immer - whatever
etw. einhalten - to keep to sth.
das Ende der Woche - end of the week
sich freuen - to be happy
freiwillig - voluntarily
etw. verlinken - to link to sth.
technisch - technical
etw. auffallen - to notice sth.
nämlich - namely
übersetzen - to translate
missverständlich - unclear
nicht jeder - not everyone
großartig - great
präzise - accurate
etw. gründen - to found sth.
etw. mit etw. speisen - to feed sth. into sth.
im Prinzip - basically
die Formulierung - phrasing
etw. vergleichen - to compare sth.
etw. anpassen - to modify sth.
Eins zu Eins - one-to-one
der Vorschlag - proposal
etw. ausdrücken - to express sth.
unterstreichen - to underline sth.
beeindruckend - impressive
künstliche Intelligenz - artificial intelligence
befreundet sein - to be friends 
der Anwalt - lawyer
schriftlich - in written form
die Quelle - source
bestimmt - certain
der Sachverhalte - facts of the case
der juristische Text - legal text
jmd. beauftragen - to hire sb.
die Maschine - machine
das Übersetzungsbüro - Translation Office
etw. ersetzen - to replace sth.
im weitesten Sinne - in the broadest sense
das Sonnendeck - sun deck
etw. begraben - to bury sth.
die Biegung - bend
der Fluss - river
sterben - to die
die Erde - earth
sowohl … als auch - both … and also
irgendwie - kind of
der Gedanke - the thought
um etw. gehen - to be about sth.
sich mit etw. decken - to coincide with sth.
die Textzeile - lyrics
weinen - to cry
der Steuerberater - tax consultant
der Finanzdienstleister - financial service provider
die Altersvorsorgeaufwendungen - retirement expenses
Gedanken lesen - to read minds
etw. verschenken - to gift sth.
etw. verkaufen - to sell sth.
das Fleisch - meat
sich mausern - to blossom out to sth.
im Herzen - at heart
willkommen sein - to be welcome
sich ändern - to change
So schnell kann es gehen. - Things can go fast like that.
etw. falsch verstehen - to misunderstand sth.
macht ja nichts - no problem
trotzdem - anyway
quatschen - to chat
spannend - exciting
etw. zu schätzen wissen - to appreciate sth.
mehr oder weniger - more or less
der Weg zur Arbeit - way to work
zum Schluss - finally
ein Teil meines Lebens - a part of my life
der Fehler - mistake
die Nachricht - message
antworten - to reply
liebe Grüße - many greetings
beeindruckt - impressed
krass  - here: really 
Das ist der Hammer! (ugs.) - That's awesome! (colloq.)
nett - nice
etw. vertagen - to adjourn sth.
etw. abspielen - to play sth.
auf etw. zurückkommen - to get back to sth.
ein andermal - some other time
herzlich - heartily
die Gegend - region
wissend - knowing
das Büro - office
dunkel - dark
am anderen Ende der Leitung - at the other end of the line
bewegt sein - to be touched 
es dabei belassen - to leave it at that 
einspielen - to play 
abspeichern - to save
etw. nachholen - to make up for sth.
In diesem Sinne, ab in die Rinne! (Redewendung / ugs.) - On that note, into the gutter! (weird saying / colloq.)
ab jetzt - from now on
um Gottes Willen - heaven's no
jmd. vor etw. bewahren - to protect sb. from sth.
die Kneipe - pub
sitzen - to sit
sich für etw. anmelden - to sign up for sth.
der Musiker - musician
passieren - to happen
die soziale Aktivität - social activity