sehr laut - very loud
sich steigern - to increase
schreien - to shout
gute Laune haben - to be in a good mood
woher kommt etw. - where does sth. come from
noch besser - even better
sich bedanken - to say thank you
etw. merken - to realize sth.
etw. feststellen - to notice sth.
lang dauern - to take long
etw. realisieren - to realize sth.
jdn. auf etw. ansprechen - to approach sb. about sth.
das Umfeld - personal sphere
die Auswirkung - impact
sowohl … als auch - both … and
witzig - funny
bestimmt - certainly 
jmd. wieder treffen - to see sb. again
das halbe Jahr - half the year
was ist los - what's going on
der Seelenstriptease - soul striptease
persönlich - personal
unpersönlich - impersonal
meistens - most of the time
schon einiges - quite a bit
die Meinung - opinion
spannend - fascinating
die Schwester - sister
vergesslich sein - to be forgetful
die Lobeshymne - hymn of praise
jmd. erwähnen - to mention sb.
nützlich - useful
die Sicht - point of view
etw. betreffen - to affect sth.
verstehen - to understand
das Basisvokabular - basic vocabulary
der Muttersprachler - native speaker
überall - everywhere
sich mit jmd. unterhalten - to talk to sb.
fließend - fluently
in ein Loch fallen (ugs.) - to fall into a hole (colloq.)
nervig - annoying
etw. lernen - to learn sth.
eigentlich - actually
deutlich - clearly
langsam - slowly
sich mit etw. umgeben - to surround oneself with sth.
jmd. zuhören - to listen to sb.
über etw. nachdenken - to think about sth.
zusätzlich - additionally
deswegen - therefore
sich verbessern - to improve
sich an etw. gewöhnen - to get used to sth.
stressfrei - without stress
dazwischen - in between
ab und an - now and then
etw. wiederholen - to repeat sth.
etw. nachgucken - to look sth. up (colloq.)
die Selbstbeweihräucherung - self-congratulation
das stimmt - that's true
jmd. für etw. loben - to praise sb. for sth. 
auf die Idee kommen - to conceive an idea
ursprünglich - originally
mit etw. um die Ecke kommen (ugs.) - to suggest sth. (ugs.)
sich vorstellen - to picture
enthusiastisch - enthusiastic
reagieren - to react
dagegen - to be against
etw. vorhersehen - to predict sth.
die Neugier - curiosity
etw. ausprobieren - to give sth. a try
sich etw. vorstellen - to imagine sth.
die Deutschlehrerin - German teacher
die Karriere - career
früher - in the past
an etw. dranbleiben - to continue with sth.
der Lebensweg - journey through life
etw. zu sagen haben - to have sth. to say
ziehen nach - to move to
umziehen - to move
entweder oder - either or
etw. kombinieren - to combine sth.
zu Recht - with good reason
auf etw. hinweisen - to indicate sth.
trotzdem - nevertheless
in der Regel - in general
eher - rather
grundsätzlich - basically
die Faustregel - rule of thumb
etw. korrigieren - to correct sth.
etw. verbreiten - to spread sth.
auf etw. ankommen - to depend on sth.
jmd. bezeichnen - to call sb.
der Fuchs - fox
der Fehler - mistake
etw. herausfinden - to find out about sth.
die Wohnungssuche - apartment-hunting
an etw. anschließen - to continue with sth.
einfach - simply
nahtlos - seamless
erstmal - at first
leidig - tedious
die Wahrheit - truth
keinen Bock haben (ugs.) - to not be in the mood (colloq.)
sich neigen / vor etw. beugen - to bend (to sth.)
etw. vorschlagen - to suggest sth.
gewünscht sein - to be requested
funktionieren - to work out
etw. begegnen - to be faced with sth.
der Überblick - overview
sich wundern - to be wondering
todlangweilig - deadly boring
amüsant - entertaining
schmerzlos - painless
doof - stupid
anstrengend - exhausting
ätzend - awful
schwierig - difficult
der Ausländer - foreigner
durchaus - absolutely
etw. verschweigen - to keep quiet about sth. sth.
aufgrund von - because of
der Rassismus - racism
etw. belegen - to prove sth.
der Nachname - surname
diskriminiert werden - to be discriminated against
die Entscheidung - decision
sich etw. erlauben - to afford sth.
die Wohngemeinschaft - apartment share
der Unterschied - difference
die Anzeige - advertisement
die Zweck-WG - shared apartment (for financial reasons)
das Gegenteil - opposite
den Ball übergeben - to pass the ball
billig - cheap
mit jmd. befreundet sein - to be friends with sb.
zwischendurch - from time to time
tendenziell - tends to be
häufig - frequently
die Möglichkeit - opportunity
das Wohnheim - dormitory
günstig - affordable
die geteilte Küche - shared kitchen
das Badezimmer - bathroom
scheiße - shit
ein Zimmer teilen - to share a room
völlig - completely
von etw. geschockt sein - to be shocked by sth.
überhaupt nicht - not at all
sparen - to save money
manchmal - sometimes
der Fremde - stranger
wobei - whereas
das Bekannte - the familiar
zumindest - at least
vielleicht - maybe
die Kindheit - childhood
aufwachsen - to grow up
über etw. sprechen - to speak about sth.
individualistisch - individualistic
der Platz - space
etw. gebrauchen - to use sth.
sich mit sich selbst beschäftigen - to spend time with oneself
natürlich - of course
der Normalfall - normal case
etw. gewohnt sein - to be used to sth.
die Privatsphäre - privacy
möbliert - furnished
unmöbliert - unfurnished
der Herd - stove
in der Regel - usually
die Spüle - sink
die Möbel - furniture
teuer - expensive
etw. mitbezahlen - to pay for sth. too
die Unterscheidung - differentiation
die Zwischenmiete - temporary rental
zwangsläufig - inevitably
dauerhaft - permanently
ohne Ende - without end
etw. nennen - to call sth.
etw. festlegen - to define sth.
der Mieter - tenant
normalerweise - normally
etw. kaputt machen - to break sth.
der Themenbereich - subject area
überhaupt - anyway
etw. verlinken - to link sth. up
das Größte - biggest
sich an jmd. richten - to be meant for sb.
mindestens - at least
etw. nachgucken - to look sth. up
schauen - to look
Wie siehst du das? - What do yout think about that?
nämlich - namely
ehemalig - former
der Praktikant - intern
die Wohnungssuche - apartment search
eine WG gründen - to set up a shared apartment 
einerseits - on the one hand
etw. speichern - to save sth.
etw. eingeben - to input sth.
der Bezirk - district
höchstens - at the most
sozusagen - so to speak
das Angebot - offer
etw. entsprechen - to match sth.
der Schnellste - fastest
etw. reinstellen - to post sth.
die Anfrage - request
etw. dicht machen (ugs.) - to close sth. up (colloq.)
das Suchgebot - the search offer
jmd. kennen - to know sb.
jemand - someone
bei jmd. melden - to contact sb.
nach etw. schauen - to look for sth.
das Geheimnis - secret
der Erfolg - success
liegen - to be located at
sich für etw. bewerben - to apply for sth.
etw. einschätzen - to estimate sth.
ungefähr - approximately
die Ruhe - silence
selber - yourself
der nächste Schritt - next step
weitergehen - to go on
die Tageszeitung - daily newspaper
sich etw. bewusst sein - to be aware of sth.
der Bewerber - applicant
die Suchannonce - search ad
die Vermieterin - landlady
ziemlich alt - quite old
fünfundsiebzig - seventy-five
tatsächlich - actually
die Eltern - parents
die Bewerbung - application
eben - just
bestimmt - probably
etw. abschicken - to send sth.
antworten - to answer
die Erste - the first
jmd. einladen - to invite someone
die Mitgliedschaft - membership
etwas Besseres - something better
die Verzweiflung - desperation
etw. ausprobieren - to try sth. out
für etw. zahlen - to pay for sth.
der Vorteil - advantage
das Postfach - mailbox
keine Lust haben - to not want to
sichtbar sein - to be visible
sich etw. erkaufen - to buy sth.
die Exklusivität - exclusivity
das Verhältnis - ratio
Geld verdienen - to make money
das Wichtigste - most important thing
überhaupt - ever
überhaupt - actually
ausziehen - to move out
der Bekanntenkreis - circle of friends
etw. weitergeben - to share sth.
irgendein - any
das Netzwerk - network
jmd. Bescheid sagen - to let sb. know
etw. über jmd. vermitteln - to pass sth. on through sb.
etw. empfehlen - to recommend sth.
das Gesuch - request
sogar - even
wohnen - to live
jmd. um etw. bitten - to ask sb. for sth.
wohl - probably
abgesehen davon - apart from that
von etw. abraten - to advise against sth.
hilfreich sein - to be useful
mittlerweile - meanwhile
das Gemeinschaftsbüro - shared office
bestimmte - specific
seitdem - since then
einige - some
sich austauschen - to communicate
auf arabisch - in arabic
mit jmd. schreiben - to write with sb.
etw. zusammentragen - to compile sth.
der Wahnsinn - awesome
der Ratgeber - guidebook
die Nationalität - nationality
nochmal - again
etw. vorbereiten - to prepare sth.
mittlerweile - by now
der Betrüger - swindler
der Wohnungsmarkt - housing market
toll klingend - great-sounding
überweisen - to transfer
die Kaution - security deposit
der Schlüssel - key
jmd. an einen Ort führen - to take sb. someplace
jmd. gehören - to belong to sb.
auf etw. warten - to wait for sth.
vorsichtig - carefully
vorher - previously
sich schützen - to protect oneself
etw. zurückbekommen - to get sth. back
so eine Art - a kind of
das Pfand - deposit
die Monatsmiete - monthly rent
gesetzlich - by law
geregelt - regulated
ein Konto einrichten - to open an account
kostenlos - free of charge
etw. dürfen - to be allowed
etw. kaputt machen - to damage sth.
etw. zurückzahlen - to pay sth. back
sicherer - safer
betrügerisch - fraudulent
tatsächlich - real
der Name - name
handeln - to act
befugt sein - to be authorized
wachsam sein - to be alert
sich etw. überlegen - to consider sth.
komisch - weird
etw. an jmd. vermitteln - to arrange sth. for sb.
die Wohnungsbesichtigung - apartment viewing
etw. unterschreiben - to sign sth.
der Rand einer Stadt - outskirts of a city
der Rollladen - shutter
dunkel - dark
reingehen  - to go inside 
der Vertrag - contract
jmd. etw. vorlegen - to submit sth. to sb. 
angeblich - allegedly
etw. anbieten - to offer sth.
im Endeffekt - at the end of the day
im Zweifel - in case of doubt
auf etw. reinfallen - to be fooled by sth.
etw. ansprechen - to bring sth. up
der Makler - real estate agent
etw. vermitteln - to arrange sth.
die Provision - commission
zusätzlich - in addition
der Anfang - in the beginning
etw. zurück kriegen - to get sth. back
etw. verkraften - to cope with sth.
kurzfristig  - short-term 
die Warmmiete - rent including running costs
die Kaltmiete - basic rent
verwirrend - confusing
früher - previously
der Mietvertrag - tenancy agreement
der Mietpreis - the rent
zu etw. gehören - to include sth.
die Nebenkosten - running costs
die Müllabfuhr - garbage disposal
die Reinigung - cleaning
der Hausflur - hallway
der Hausmeister - janitor
zuständig - responsible
der Feuermelder - fire detector
die laufenden Kosten  - ongoing expenses 
sich mit etw. beschäftigen - to deal with sth.
der Zusatz - addition
vor kurzem - not long ago
etw. ändern - to change sth.
meistens - mostly
das Gesetz - law
der Auftraggeber - principal
in den meisten Fällen - in most cases
die Lücke füllen - to fill the gap
sich selbst langweilen - to be bored
die Unterlagen - documents
der Einkommensnachweis - proof of income
in irgendeiner Weise - in some manner
die Gehaltsabrechnung - payroll
ähnlich - similar
die Schufa - German society for the securing of loans
die Schweinerei (ugs.) - scandal (colloq.)
kreditwürdig - creditworthy
frisch (ugs.) - new (colloq.)
die Schufabescheinigung - schufa credit rating
kostenlos - free of charge 
versteckt sein - to be hidden
lang und breit erklären (ugs.) - explain thoroughly (colloq.)
etw. hassen - to hate sth.
einmal im Jahr - once a year
etw. verlinken - to link to sth. 
die Mietschuldenfreiheitsbescheinigung - certificate of rental debt-free status
die Bescheinigung - certificate
der Brief - letter
vorherig - previous
die Mietschulden - rent debts
bei den Eltern wohnen - to live with parents
jmd. retten - to save sb.
die Bürgschaft - surety
für jmd. bürgen - to act as sb's guarantor
die Absicherung - protection
zum ersten Mal - for the first time
etw. abschließen - to finish sth.
langweilig - boring
aller Zeiten - of all times
etw. zweimal überlegen - to think twice about sth.
der Themenwunsch - topic request
die Zukunft - future
etw. erwähnen - to mention sth.
die Traumwohnung - apartment of your dreams
geil (ugs.) - awesome (colloq.)
bekloppt (ugs.) - wacky (colloq.)
an einem Ort bleiben - to stay in one place
darum gehen - to involve
sich mit etw. herumschlagen (ugs.) - to deal with sth. (colloq.)
reich - rich
um etw. kümmern - to take care of sth.
in Erwägung ziehen - to consider
Möbel aufbauen - to put up furniture
etw. besitzen - to own sth.
der Ausdruck - expression
die Überleitung - transition
die Firma - company
etw. einpacken - to pack sth.
woanders - somewhere else
unbedingt - necessarily
der Krach - noise
die Kreuzung - intersection
das Schlafzimmer - bedroom
fortschreitend - ongoing
die Mietlänge - rental length
das Geräusch - noise
die Straßenbahn - tram
etw. selber machen - to do sth. yourself
etw. machen lassen - to have sth. done
der Umzug - move
über etw. sprechen  - to speak about sth. 
etw. selber einpacken - to pack sth. yourself
die Kiste - box
etw. tragen - to carry sth.
das Bierchen (ugs.) - beer (colloq.)
trinken - to drink
jmd. beauftragen - to hire sb.
tatsächlich - in fact
die Sachen - things
etw. vorsortieren - to presort sth.
das Regal - shelf
genauso - exactly the same
etw. schon mal gemacht haben - to have done sth. before
das Umzugsgeld - relocation allowance
das Ding ist (ugs.) - the thing is (colloq.)
etw. verschwenden - to waste sth.
etw. aus dem Fenster schmeißen (ugs.) - to waste sth. (colloq.)
damals - back then
frei verfügbar - freely available
die Richtlinien - guidelines
etw. ausgeben - to spend sth.
jmd etw. in den Rachen werfen (ugs.) - to throw sth. after someone (colloq.)
eine Frage des Geldes - a question of money
eine Frage des Alters - a matter of age
vorkommen - to occur
etw. auffallen - to notice sth.
jmd. etw. anbieten - to offer sb. sth.
gerade bei jmd. - especially with sb.
das scheint mir - that seems to me
ungewöhnlich - unusual
gegenseitig - each other
sich aufdrängen - to impose oneself
etw. schleppen - to carry sth.
das Butterbrot - sandwich
helfen - to help
das Kriterium - criterion
der echte Freund - real friend
sich gegenseitig helfen - to help each other
sich helfen lassen - to let sb. help you
beleidigt sein - to be offended
mitmachen lassen - to let sb. join in
Party machen - to party
übrigens - by the way
der Freundeskreis - circle of friends
auseinander fallen - to break apart
der Fußboden - floor
etw. verlegen - to lay sth.
all solche Sachen - all such things
normalerweise - usually
eingespielt sein - to be working well together
die Erinnerung - memory
einrichten - to furnish 
etw. schaffen - to manage sth.
die Decke - ceiling
verschwitzt sein - to be sweaty
die Schlepperei (ugs.) - towing (colloq.)
glücklich sein - to be happy
etw. vergessen - to forget sth.
etw. schweißt zusammen - sth. bonds people 
rückwirkend - retrospectively
beschreiben - to describe
behandeln - to treat
etw. anmalen - to paint sth.
die Tapete - wallpaper
etw. abreißen - to pull sth. down
auf dem Schirm haben (ugs.) - to remember sth. (colloq.)
schweißtreibend - arduous
das Unterfangen - undertaking
die Schicht - layer
etw. abkratzen - to scrape sth. off
tagelang - for days
die Anstrengung - effort
feucht - wet
eklig - disgusting
die Matratze - mattress
am nächsten Morgen - the next morning
der Bulli (ugs.) - van (colloq.)
endlich - finally
lieb - nice
der Umzugsstress - moving stress 
einwöchig - weeklong
etw. voll stellen - to stuff sth. 
bis zum Anschlag - completely
reinpassen - to fit in
sich erinnern - to remember
sich anstrengen - to make an effort
der Übergang - transition
in einem Wisch (ugs.) - in one sweep (colloq.)
etw. auswählen - to choose sth.
öfters - more often
etw. umbenennen - to rename sth.
etw. einfallen - to think of sth.
singen - to sing
sich über jmd./etw. lustig machen - to make fun of sb./sth.
das Gegenstück - opposite
miteinander verschmelzen - to fuse together
etw. schaffen - to create sth.
die Mischung - mix
abgesehen von etw. - besides sth.
schreiben  - to write
bekannt - well-known
der Künstler - artist
die Zeile - line
der Teil - part
es geht drum (ugs.) - it's about (colloq.)
heutzutage - today
etw. mithören - to listen to sth.
der Musikgeschmack - musical taste
jmd. hören - to hear sb.
die Frage - to get sth.
jmd. ausschalten - to eliminate sb.
die philosophische Frage - philosophical question
die Art - the kind
schlimm - terrible
etw. schön finden - to like sth.
etw. als etw. empfinden - to perceive sth. as sth.
manche Menschen - some people
zum Beispiel - for instance
behaupten - to assert
die Sechziger - the sixties
die Generation - generation
gefallen - to like
der Lärm - noise
zustande kommen - to come about
mit etw. anfangen - to begin with sth.
sich überlegen - to think about sth.
betrachten - to consider
die Stimme - voice
der Ablauf - procedure
die Mischung - mixture
der Geschmack - taste
mit etw. zusammenhängen - to be related to sth.
wahrscheinlich - probably
etw. definieren - to define sth.
das Selbstbild - self-image
identifizieren - to identify
etw. sagt etw. aus - sth. indicates sth.
etw. entsprechen - to correspond to sth.
sinnlos - pointless
die Botschaft - message
unterschiedlich - different
ausgeprägt - distinctive 
die Schönheit - beauty
etw. als schön empfinden  - to perceive sth. as beautiful
der Schlager - entertainer music
der Ballermann  - party area in Mallorca
saufen (ugs.) - to guzzle (colloq.)
sexistisch - sexist
etw. repräsentieren - to represent sth.
sich etw. vorstellen - to think of sth.
mit etw. auseinandersetzen - to deal with sth.
der Einfluss - impact
etw. behalten - to keep sth.
etw. schätzen - to appreciate sth.
mein ganzes Leben - all my life
die Siedlung - settlement
zu etw. gehören - to be part of sth.
von außen - from the outside
komischerweise - oddly enough
in etw. ausgedrückt - expressed in terms of sth.
angelehnt sein an - to be based on
heute - today
sondern - but instead
musikalisch gesehen - musically speaking
zusammensitzen - to sit together
etw. erleben - to experience sth.
die Schwierigkeiten - difficulties
etw. nachsingen - to sing sth. after sb.
das musikalische Gehör - musical ear
sich verändern - to change
etw. aufbauen - to set sth. up
der Faktor - factor
gesellschaftlich - social
der Einfluss - influence
hinreichend - adequately
ausreichend - sufficiently
abschließend - conclusively
die Antwort - answer
entweder oder  - either or
immer weniger - less and less
die Audionachricht - audio message
am allerschönsten - most beautiful
Spaß machen - to be fun
mit jmd. quatschen (ugs.)  - to have a chat with sb. (colloq.)
editieren - to edit
zwei Drittel - two-thirds
sich verabschieden - to say goodbye
zufällig - randomly
der Anfang - beginning
die ersten zwei Sätze - the first two sentences
jmd. etw. vorlesen - to read sth. to sb.
wunderschön - wonderful
passend - fitting
etw. angucken - to take a look at sth.
sehr gerne - with pleasure
der Fernsehsender - TV station
der Rundfunk - broadcasting
die Reihe - series
die Art und Weise - manner
der Konflikt - conflict
das Jahrzehnt - decade
das Jahrhundert - century
verfeindet sein - to be enemies
innerhalb - within
der Vorteil  - advantage 
der Nachteil - disadvantage
kurzweilig - entertaining
etw. aussprechen - to say sth.
beim Reden - while speaking
ähnlich zu etw. - similar to sth.
erarbeiten - to work out
abarbeiten - to work through
bearbeiten - to work on
mit jmd. sprechen - to speak to sb.
besprechen - to discuss
ansprechen - to bring up
schicken - to send
verschicken - to mail
abschicken - to send off
jmd. fragen - to ask sb.
an etw. herankommen - to reach sth.
etw. anpacken - to tackle sth.
etw. anfassen - to touch sth.
das Verständnis für - an understanding of
bisher - so far
die Anfrage - inquiry
demnächst - soon
die Variante - option
froh sein - to be joyful
etwas Verbindendes - something connecting
weggehen - to go away
kaputtgehen - to break
vor etw. sitzen - to sit in front of sth.
der Stamm - root word
in irgendeiner Form - in some way
etw. positiv sehen - to be positive about sth.
bekloppt (ugs.) - stupid (colloq.)
sich vorstellen - to imagine
nachfragen - to enquire
nochmal nachfragen - to ask again
etw. verstehen - to understand sth.
verständlich - understandable
bei manchen - in some
etw. suchen - to search for sth.
versuchen - to try
nach etw. suchen - to look for sth.
jmd. verwirren - to confuse sb.
versprechen - to promise
brechen - to break
beginnen - to begin
mit etw. aufhören - to end sth.
das Problem - problem
spannend - exciting
die Sprachgeschichte - history of language
die Schulter - shoulder
schaffen - to accomplish
die wenigsten - very few
der Held - hero
es geschafft haben - to have made it
stolz auf jmd. sein - to be proud of somebody
auf jeden Fall - definitely
jede Woche - every week
etw. durchhalten - to endure sth.
das Ende - end 
das Schneiden - editing