Los geht's! - Let's go!
Na klar! - Of course!
der Nachmittag - afternoon
jmd. zuvorkommen - to get in ahead of sb.
die Stille - silence
der Anfang - beginning
das Missverständnis - misunderstanding
für Fortgeschrittene - for advanced learners
gleichzeitig - at the same time
der Untertitel - subtitle
unterstützen  - to support 
das Hauptprodukt - main product
etw. nachgucken - to look sth. up
jmd. auffallen - to notice sth.
nervig - annoying
gucken - to look
das Alleinstellungsmerkmal - the unique selling proposition
abertausend - thousands upon thousands
etw. sein lassen - to stop doing sth.
der Anfänger - beginner
verstehen - to understand
belassen wir es dabei - let's leave it at that
über den Haufen werfen (ugs.) - to abandon sth. (colloq.)
beruhigt sein - to be reassured
Das war knapp! - That was close!
einsteigen - to start things off
der Minimalismus - minimalism
das Lieblingsthema - favorite subject
das Ding - the thing
sich etw. ausdenken - to think up sth.
bedeuten - to mean
inwiefern - in which way
davon halten - to think of it
lustig - funny
zum Teil - partly
das Mädel (ugs.) - girl (colloq.)
am Ende  - in the end 
generell - in general
das Ergebnis - result
besitzen - to own
beschreiben - to describe
auf jeden Fall - definitely
die Empfehlung - recommendation
der Trend - trend
aufräumen - to tidy up
Wie war das nochmal? - What was that again?
scheiße (ugs.) - shit (colloq.)
zum Punkt kommen - to get to the point
von Natur aus - by nature
erklären - to explain
überlegen - to consider
die Freude - joy
mittlerweile - meanwhile
das Gefühl haben - to have the feeling
vorlesen - to read aloud
Nummer Eins - Number One
Oh je! (ugs.) - Oh dear! (colloq.)
schaffen - to manage
sich von etw. trennen - to get rid of sth. 
das Konzept - concept
festgelegt - established
die Lebensphilosophie - the philosophy of life
das Ding - thing
sich von etw. ablenken lassen - to be distracted by sth.
ausgezeichnet - excellent
etw. ansprechen - to bring sth. up
möglichst wenig - as little as possible
besitzen - to possess
überhaupt nicht - not at all
die Lebensqualität - quality of life
hinzufügen - to add
nötig - necessary
abhängig davon - depending on that
der Gegenstand - object
der Rucksack - backpack
die Unterhose - underpants
der Quatsch (ugs.) - nonsense (colloq.)
witzig - funny
Leute - people
die Regel - rule
mit etw. kämpfen - to struggle with sth.
reduzieren - to reduce
der Kopf - head
das Bedürfnis empfinden - to feel the need
zählen - to count
tief drinnen - deep inside
brauchen - to need
verkaufen - to sell
obwohl - although
knallhart (ugs.) - really tough (colloq.)
andere Sachen sind angesagt - other things on the agenda 
benutzen - to use
die Weltreise - round-the-world trip
mehr oder weniger - more or less
sich verabschieden - to say goodbye
nichts mehr wert - no longer worth anything
im Arsch (ugs.) - broken (colloq.)
sich trennen - to get rid of
neu - new
der Gedanke - thought
wahrscheinlich - probably
das Handtuch - towel
die Bettwäsche - bed sheets
sich erlauben - to take the liberty
sich dreimal überlegen (ugs.) - to think twice (colloq.)
gebraucht - second-hand
der Flohmarkt - flea market
zu Fuß - by walking
der Schnäppchenjäger - bargain hunter
die Zahnpasta - toothpaste
das geht ab (ugs.) - here: it starts well (colloq.)
aus Sicht - from the perspective of
der Besucher - visitor
die Erfahrung - experience
mieten - to rent
der Stand - (market) stand
die Kiste - box
wertvoll - valuable
feilschen - to bargain
beide Male - both times
der Verkäufer - seller
der Profi - expert
nachmittags - in the afternoon
brunchen - to have brunch
die Krawatte - tie
drehen - to turn
das Geld wieder raus haben - to recover the money
umgangssprachlich - colloquially
auf der Arbeit - at work
im Grunde - basically
der Ausdruck - expression
der Chef - boss
in der Regel - normally
im Sinne - in the interest
der Zuhörer - listener
spannend - fascinating
die Lebenseinstellung - attitude to life
strukturieren - to structure
die Versicherung - insurance
etw. abschließen - to conclude sth. 
sich mit etw. beschäftigen - to be preoccupied with sth.
die Ordnung - tidiness
ordnen - to order
schaffen - to create
der Vertrag - contract
die Erinnerung - reminder
kündigen - to quit
das gefällt mir - I like that
definieren - to define
weitestgehend - largely
aufwachsen - to grow up
von Menschen umgeben sein - to be surrounded by people
gelingen - to succeed
der Umzug - move
Lust haben - to be in the mood
mitschleppen - to carry along
wegwerfen - to throw away
die Bedeutung - meaning
sich etw. einbilden - to imagine sth.
schenken - to give
die Verpflichtung - obligation
sich von etw. lösen - to let go of sth.
auf etw. zurückkommen - to come back to sth.
der Brief - letter
die Postkarte - postcard
der Schuhkarton - shoebox
der Umzugskarton - moving box
aussortieren - to sort out
rausschmeißen - to kick out
tatsächlich - actually
die Erinnerung - memory
das Jahrbuch - yearbook
vor vielen Jahren - many years ago
der Abschiedsbrief - farewell letter
jmd. kennenlernen - to get to know someone
riesengroß - gigantic
in Ordnung - alright
der nostalgische Wert - nostalgic value
das Foto - photo
sich erinnern - to remember
aufbewahren - to store
finden - to find
auf etw. übertragen - to apply to sth.
das Fahrrad - bicycle
flach - flat
der Berg - mountain
der Gang - gear
das Zahnrad - gear wheel
leicht - light
der Hang - slope
sich hochschleppen - to drag oneself up
mit aller Kraft - with all one's strength
schalten - to change gears
anstrengend - exhausting
das ist es mir wert - it's worth it to me
etw. nachschlagen - to look sth. up
etw. besitzen - to own sth.
die Tauschkultur - exchange culture
unfreiwillig - involuntary
die Gangschaltung - gears
der Nachteil - disadvantage
die Nachhaltigkeit - sustainability
zusammen passen - to go well together 
reich - rich
der Monat - month
schmeißen - to throw
der Müll - trash
sich etw. erlauben - to take the liberty of sth.
das Buch - book
bewusst - consciously
sich entscheiden - to decide
der Konsum - consumption
der Planet - planet
auf der einen Seite - on the one hand
geordnet - in order
die Unordnung - mess
das Gefühl - feeling
glücklich - happy
ein Haufen Dinge - a bunch of things
das Zimmer - room
etw. vollstellen - to cramp sth. full
der Haushalt - household
der Sammler - collector
die Tatsache - fact
die Auswahl - choice
bestimmt - certain
sammeln - to collect
die Unterlage - document
etw. aushalten - to endure sth.
die Beziehung - relationship
die Vorstellung - idea
nachhaltig - sustainable
die Kleidung - clothes
das Essen - food
das Fleisch - meat
Bio - organic
ständig - constantly
einkaufen - to shop
jeden Tag - every day
waschen - to wash
schrecklich - terrible
sich ähnlich sein - to be alike
angenehm - comfortable
das Umfeld - surrounding
bewerten - to judge
Witze machen - to joke
menschenverachtend - inhuman
die Bedingung - condition
etw. herstellen - to produce sth.
in den Müll wandern - to end up in the trash
hundertprozentig - one hundred percent
hoffen - to hope
eine Frage des Luxus - a question of luxury
recht haben - to be right
der Zugang - access
extravagant - extravagant/ fancy
die Wohnung - apartment
der Lebensstil - lifestyle
sich etw. beibehalten - to stick with sth.
Angst haben - to be afraid
zum ersten Mal - for the first time
Geld verdienen - to make money
sich etw. leisten - to afford sth.
die Einzimmerwohnung - one-room apartment
die Küche - kitchen
wenig Platz - limited space
klarkommen - to get by
reisen - to travel
etw. bewahren - to keep sth.
sich etw. abgewöhnen - to give up sth.
vergrößern - to enlarge
dementsprechend - accordingly
etw. bestätigen - to confirm sth.
der Begriff - term
sich leisten - to afford
das Auto - car
die Falle - trap
Träume verwirklichen - to make dreams come true
ausgeben - to spend
das Haus unterhalten - to maintain the house
bezahlen - to pay
abstellen - to turn off
mit wenig auskommen - to get by on little
die Abhängigkeit - dependence
manövrieren - to navigate
das Gespräch - conversation
Schieß los! (ugs.) - Go ahead! (colloq.)
die nächsten zehn Jahre - the next ten years
auswählen - to choose
voll - full
wegschmeißen - to throw away
weggeben - to give away
quasi - basically
austauschen - to exchange
verhandeln - to negotiate
besorgen - to get
behalten - to keep
der Rechner - computer
die Zahnbürste - toothbrush
bleiben - to stay
furchtbar - horrible
die Belastung - burden
eine Weile - for a while
der Zeitraum - period of time
passieren - to happen
knapp - tight
die Klapp-Wand - folding wall
der Sichtschutz - partition
umziehen - to change
die Ecke - corner
die Hälfte - half
versuchen - to try
witzigerweise - funnily enough
die Schweiz - Switzerland
Untermiete - sublease
lagern - to store
gestapelt - stacked
der Sessel - armchair
die Pfanne - frying pan
der Topf - pot
vergessen - to forget
das Thema - subject
spartanisch - spartan
die Antike - ancient times
der Hauptort - capital
die Landschaft - landscape
berühmt - famous
kämpfen - to fight
das Heer - army
der Kämpfer - fighter
die Gesellschaft - society
keine Ahnung - no idea
schlicht - simple
eingerichtet - furnished
kommt darauf an - depends on
die Feststellung - remark
die Möbel - furniture
beschränken - to limit
alles mit drin - all included
das Kompliment - compliment
wohnen - to live
besuchen - to visit
einziehen - to move in
das Bild - painting
der Schrank - wardrobe
die Klamotten - clothes
die Ausrüstung - equipment
der Zusammenhang - context
die Einrichtung - home furnishings
übersichtlich - clearly arranged
interpretieren - to interpret
Ich bin dran!  - It's my turn! 
sich über etw. freuen  - to be happy about sth. 
darüber reden - to talk about it
einen Aufruf starten - to make an appeal
recherchieren - to do research
die Auswirkung - impact
die Raucherkneipe - smokers' bar
verboten - forbidden
etw. einführen - to introduce sth.
klagen - to sue
die Einraumkneipe - one-room pub
die Theke - bar
der Umsatzverlust - loss of revenue
das Gericht - court
nachweisen - to prove
ein Verbot kippen - to vote down a ban
die Kneipe - pub
im Endeffekt (ugs.) - in the end (colloq.)
erlauben - to allow
die Umgebung - surrounding area
trennbar - separable
der Nichtraucher - non-smoker
die Macht - power
trotzdem - nevertheless
trinken - to drink
das Wochenende - weekend
stundenlang - for hours
der Husten - cough
das Auge - eye
die Kleidung - clothing
bekloppt (ugs.) - crazy (colloq.)
die Gesundheit - health
von heute auf morgen - overnight
der Stammgast - regular customer
das Interesse - interest
vor allen Dingen - more importantly
vor die Tür gehen - to go outdoors
draußen - outside
zu Hause bleiben - to stay at home
das ist das Ding - that's the thing
die Überzeugung - conviction
Das ist scheiße. (ugs.) - That sucks. (colloq.)
das Gift - poison
schaden - to harm
dumm - stupid
sich etw. bewusst sein - to be aware of sth.
angreifen - to attack
mit dem Rauchen aufhören - to quit smoking
im positiven Sinne - in a positive sense
es macht ihnen nichts aus - they don't mind 
freiwillig - voluntarily
beschweren - to complain
geheim - secret
lebenslang - lifelong
sich entziehen - to escape
in gewisser Weise - somehow 
jmd. zu etw. zwingen - to force sb. to do sth.
der einzige Grund - the only reason
selten - rarely
Bock haben (ugs.) - to want to (colloq.)
steif - stiff
locker - easy
betrunken - drunk
nüchtern - sober
die Kneipenkultur - pub culture
Samstag - Saturday
Freitag - Friday
nacheinander  - one after another 
unterwegs - on the road
die Tätigkeit - activity
geschult werden - to be trained
sich unterhalten - to make small talk
empfehlen - to recommend
lange dauern - to take long
stolz - proud
gratulieren - to congratulate
sich vorstellen - to imagine
der Wandel - change
jmd. belasten - to harm sb.
etw. zu sich nehmen - to consume sth. 
im übertragenden Sinne - in the figurative sense
etw. abbrennen - to burn sth. off
giftig - toxic
die ganze Zeit  - the whole time 
das Lagerfeuer - bonfire
einatmen - to breathe in
sich aufregen - to be upset
zurückblicken - to look back
etw. zulassen - to allow sth.
das Flugzeug - airplane
die Reise - journey
quälen - to torture
der Arzt - doctor
die Arztpraxis - medical office
der Patient - patient
Lungenkrebs - lung cancer
krank - sick
damals - back then
ernsthaft - seriously
sich etw. zurückwünschen - to wish sth. back
das musste raus - this had to be said
anstauen - to become bottled-up
entgegensetzen - to oppose
außer - except
etwas Ähnliches - something similar
insbesondere - especially
der Arbeitsplatz - workplace
das Büro - office
die Ruhe - silence
etw. merken - to realize sth.
der Szenenwechsel - change of scenery
umgeben sein - to be surrounded
fremd - foreign
interagieren - to interact
der Ort - location
wuseliges Treiben (ugs.) - hustle and bustle (colloq.)
sein Ding machen - to do one's thing
kombinieren - to combine
den ganzen Tag - the whole day
wertvoll - precious
günstig - cheap
liebevoll gestaltet - lovingly designed
das Brötchen - sandwich
sich unterhalten - to support oneself
auf Reisen - traveling
kein Grund - no reason
teuer  - expensive 
unglaublich - incredibly
die Miete - rent
finanzieren - to finance
einen Kaffee trinken - to have a coffee
Prozent - percent
sitzen - to sit
gesehen werden - to be seen
verdienen - to earn
der Papierbecher - paper cup
entsprechend - according to
der soziale Raum - social space
neu erfinden - to reinvent
die Öffentlichkeit - the public 
wie zu Hause fühlen - to feel at home
das soziale Ansehen - social prestige
das Lebensgefühl - esprit
kaputt - damaged
rund - round
eckig - square
ausgerichtet - organized
der Blickwinkel - angle of vision
heutzutage - nowadays
die Marke - brand
das Segment - part
genießen - to enjoy
anrufen - to call
warten - to wait
tut mir leid - I am sorry
bereit sein - to be prepared
aufnehmen - to record
aussetzen - to fail
nachprüfen - to check
das Trauma - trauma
die Überraschung - surprise
gesellschaftlich - social
politisch betätigen - to be politically active
verbrecherisch - criminal
bekämpfen - to fight
der Unterschied - difference
das Verhältnis - relationship
die Identität - identity
sich identifizieren - to identify oneself
das Land - country
zufällig - random
die Erklärung - explanation 
die Karte - map
okkupieren - to occupy
die Monarchie - monarchy
das hat wehgetan  - that hurt 
das Königreich - kingdom
plötzlich - suddenly
versklaven - to enslave
die Bevölkerung - population
das Kulturgut - cultural heritage
unterdrücken - to suppress
unterstützen - to support
die Rolle - role
die Freiheit - liberty
der Erste Weltkrieg - First World War
am Boden liegen - to lay on the ground
die Unabhängigkeit - independence
kommunistisch - communist
unabhängig - independent
unermesslich - immeasurable
Blut vergießen - to shed blood
träumen - to dream
weinen - to cry
beten - to pray
das Land erhalten - to maintain the country
die Verhandlung - negotiation
die Entscheidung - decision
das Volk - the people
der Stress - stress
verweigern - to refuse
einen Punkt machen - to make a point
reagieren - to react
reif - mature
ruhig - calm
mit weitem Blick - outward-looking
locker werden - to relax
nachvollziehen - to understand
Westdeutschland - West Germany
sich erholen - to recover
die Vergangenheit - past
das Glück - chance
stabil - stable
missbrauchen - to abuse
geprägt werden - to be marked
beachten - to consider
etw. rüberbringen - to communicate sth.
sich annähern - to approach 
Teil von etw. sein - to be part of sth.
fremdbestimmt - externally determined
das Anführungszeichen - quotation mark
ausnutzen - to take advantage of
der Hintergrund - background
die Errungenschaft - achievement
der Schrecken - terror
zusammen arbeiten - to collaborate
der Krieg - war
bedenken - to consider
die Demokratie - democracy
die Mehrheit - majority
wählen - to vote
der Abgeordnete - Member of Parliament
sich um etw. kümmern - to take care of sth.
empfinden - to feel
der Vorwurf - reproach
formulieren - to formulate
es bei etw. belassen - to leave it at sth.
erfahren - to find out
auslösen - to initiate
die Streiterei - dispute
der Zeitpunkt - moment
erschrocken sein - to be terrified
an etw. hängen - to be attached to sth.
der Schwachsinn (ugs.) - nonsense (colloq.)
wunderschön - beautiful
die Sichtweise - perspective
etw. von zwei Seiten sehen - to see sth. from both sides 
so ungefähr - more or less
das Streitgespräch - debate
die Angelegenheit - matter 
ausarten - to degenerate
Ruhe im Karton (ugs.) - quiet (colloq.)
laut werden - to get loud
widersprüchlich - contradictory
kritisieren - to criticize
aus vielen Gründen - for many reasons
gedruckt - printed
etw. genießen - to enjoy sth.
sich etw. gönnen - to allow oneself sth.
richtig - proper
anstreichen - to highlight
so viel, wie man möchte - as many as one likes
das Gewicht - weight
lesen - to read
strahlen - to shine
Sprachen lernen - to learn languages
wertvoll - useful
zack (ugs.) - boom (colloq.)
die Übersetzung - translation
etw. nachschauen - to look sth. up
der Aufwand - effort
sich etw. anschaffen - to get sth.
Ich bin gespannt! - I'm curious!
zuhören - to listen
fleißig - busy 
die Weltkarte - world map
die Ländergröße - country size
vergleichen - to compare
geglättet - smoothed
etw. darstellen - to illustrate sth.
der Durchmesser - diameter
der Kreis - circle
der Äquator - equator
etw. strecken - to stretch sth.
die Form - shape
nördlich - north
reinziehen - to drag in
eingeben - to enter
glauben - to believe
die Fläche - surface
Quadratkilometer - square kilometers
Norwegen - Norway
Frankreich - France
unglaublich - incredible
ausgeprägt - distinctive
der Staat - state
rumspielen - to play around
Russland - Russia
gigantisch - gigantic
ungefähr - approximately
doppelt so groß - twice as big
Ägypten - Egypt
gleich groß - of equal size
ursprünglich - originally
zum Schluss - at the end
hinterlassen - to leave
bitten - to ask
verstärkende Aussage - reinforcing expression
überhaupt keine Zeit - no time at all
ganz und gar nicht - not at all
ganz lang - for a really long time
bestärkend - reinforcing
ganz toll gemacht - done a great job
das Nomen - noun
generell - generally
der Muttersprachler - native speaker
oft - often
verwenden - to use
umgekehrt - the other way around
der Schritt - step
wahllos austauschbar - randomly replaceable
konsumieren - to consume
einen Film schauen - to watch a movie
begegnen - to meet
innehalten - to pause
irgendwann - at some point
der Tipp - tip
vor Kurzem - not long ago
etw. vorstellen - to present sth.
das Beispiel - example
der Satz - sentence
austauschbar - replaceable
Mein Gott! - My God!
aufwühlend - devastating
eine Achterbahnfahrt der Gefühle (ugs.) - a rollercoaster ride of emotions (colloq.)
ruhig bleiben - to stay calm
bis bald - see you soon