es geht los - here we go
die Qualität - quality
diesmal - this time
die Internetverbindung - internet connection
die Quarantäne - quarantine
wunderschön - wonderful
das Mischpult - mixing console
ausgeschaltet - switched off
der Sitzplatz - seat
der Chef - boss
das Klopapier - toilet paper
sich die Nase putzen - to wipe one's nose
apropos - speaking of
erwähnen - to mention
um etw. bitten - to ask for sth.
folgen - to follow
die Vokabelhilfe - vocabulary helper
der Inhalt - content
unterstützen - to support
die Krisensituation - crisis situation
mittlerweile - meanwhile
global - worldwide
um etw. bestellt sein - to look like for sth.
absagen - to cancel
die Veranstaltung - event
ausfallen - to be cancelled
umsonst - for free
möglich machen - to make possible
bewusst werden - to become aware
dankbar - grateful
die Einführung - introduction
vorbei - over
die Rubrik - category
der Krisenmodus - crisis mode
die Stimmung - mood
die Überleitung - transition
das Virus - virus
sich sicher sein - to be certain
das Neutrum - neuter
klingen - to sound
darüber reden - to talk about
das Schlimmste - the worst
etw. hinter sich haben - to be past sth.
schließen - to close
die Ausbreitung - spread
verlangsamen - to slow down
kränkeln - to be sickly
im Hals kratzen - throat feels rough
die Halsschmerzen  - sore throat 
sicherheitshalber - to be on the safe side
etw. beschließen - to decide on sth.
von zu Hause aus - from home
das Büro - office
Gute Besserung! - Get well soon!
der März - March
der Unglückstag - unlucky day
sich auf etw. einstellen - to prepare for sth.
die Lage - situation
etw. bekannt geben - to make sth. public
verboten sein - to be prohibited
zumachen - to shut down
raus gehen - to go out
eng - tight
empfinden - to feel
versuchen - to try
etw. beitragen - to contribute sth.
wahrnehmen - to perceive
ablehnen - to reject
verweigern - to deny
übertrieben - exaggerated
doofe Sprüche - stupid comments
ausverkauft - sold out
der Streit - dispute
angespannt - tense
jdn. ertragen - to bear with sb.
überfordert - overwhelmed
die Krise - crisis
mit etw. zu tun haben - to be concerned with sth.
die Gefahr - danger
sich an etw. gewöhnen - to get used to sth.
sich mit etw. auseinandersetzen - to deal with sth.
die Unterscheidung - distinction
der Unterschied - difference
der Einzelne - the individual
sich Sorgen machen - to be worried
gesund - healthy
bedroht - threatened
die Bevölkerung - population
das Krankenhaus - hospital
überlastet - overloaded
etw. verhindern - to stop sth.
etw. vorhersehen - to predict sth.
zu spät - too late
das Brötchen - bread roll
spannend - exciting
die Gesellschaft - society
sich verhalten - to behave
beobachten - to watch
reagieren - to react
die Meinung - opinion
überrascht werden - to be surprised
etw. erkennen - to realise sth.
der Zeitpunkt - moment
betroffen sein - to be concerned
unbemerkt - without being noticed
verbreiten - to spread
sich vorbereiten - to prepare oneself
das Frühwarnsystem - early warning system
etw. umsetzen - to implement sth.
die Maßnahme - measure
etw. schaffen - to achieve sth.
die Kurve - curve
etw. niedrig halten - to keep sth. down
die Zeitung - newspaper
bekannt sein als - to be known as
tatsächlich - actually
führend - leading
etw. verfolgen - to follow sth.
beraten - to advise
die Bundesregierung - federal government
der Gesundheitsminister - Minister of Health
die Bundeskanzlerin - Chancellor
einkaufen - to go shopping
beruhigend - reassuring
kein Blatt vor den Mund nehmen (ugs.) - to not mince one's words (colloq.)
etw. verschönern - to play down sth.
seine Meinung ändern - to change one's mind
revidieren - to revise
die Studie - study
unaufgeregt - calm
innerhalb - within
zu etw. avancieren - to advance to sth.
täglich - daily
das Fernsehen - television
die Art - way
der Zuhörer - listener
das ist ja der Wahnsinn (ugs.) - that's amazing (colloq.)
die Nachrichten - news
die AfD (Alternative für Deutschland) - Alternative for Germany (far-right political party)
untergehen - to drown in the noise
etw. besprechen - to discuss sth.
der Teil - part
der Flügel - wing
rechtsextrem - right-wing extremist
ungefähr - approximately
ein Drittel - one third
offen - open
Ansichten vertreten - to represent opinions
die Prüfung - inspection
der Verfassungsschutz - protection of the constitution
die Verfassung - constitution
der Nachrichtendienst - intelligence service
überwachen - to monitor
herzlich spät - extremeley late
feststellen - to identify
abhören - to observe
verhindern - to prevent
eine Gefahr darstellen - to be dangerous
an der Macht sein - to be in power
die Gesellschaftsform - society structure
konform - corresponding
die Demokratie - democracy
abschaffen - to abolish
das Staatsvolk - people of the state
etablieren - to establish
regnen - to rain
verfassungswidrig - unconstitutional
demokratisch - democratic
überraschend - surprisingly
verbeamtet sein - to have the status of civil servant
der Staat - state
der Polizist - policeman
der Soldat - soldier
gefährlich - dangerous
unter Beobachtung stehen - to be under observation
etw. besiegeln - to seal sth.
wichtig - important
bis vor kurzem - until recently
der Linke - left-wing political person
gegen jdn. aufstehen - to rise up against sb.
die Mehrheit - majority
die Bedrohung - threat
jdm. etw. überlassen - to leave sth. to sb.
der Einfluss - influence
das Zitat  - quote 
kompliziert - complicated
der Rechte - right-wing political person
angehörig - belonging to
jdm. etw. vorwerfen - to accuse sb. of sth.
etw. verschleiern - to cover up sth.
schützend - protecting
tendieren - to tend
unvorstellbar - unimaginable
zu etw. übergehen - to switch to sth.
harmlos - harmless
jdn. duzen - to adress sb. as Du
jdn. siezen - to adress sb. as Sie
die Höflichkeitsform - polite form
Indien - India
sich erinnern - to remember
bezüglich - regarding
die Älteren - older people
das Kind - child
recherchieren - to do research
auf den ersten Blick - at first sight
verschieden - different
französisch - French
ungarisch - Hungarian
die Anredeform - form of address
die Nähe - proximity
die Vertraulichkeit - familiarity
die Förmlichkeit - formality
die Herkunft - origin
die Ansprache - address
das Märchen - fairy tale
laut diesem Artikel - according to this article
Distanz schaffen - to create distance
mit dem Finger auf jdn. zeigen - to point a finger at sb.
entstehen - to be created
die Gruppe - group
grundsätzlich - basically
wechseln - to change
das Lebensjahr - year of one's life
klar - clear
gleichzeitig - at the same time
die Schulklasse - school class
die Oberstufe - senior classes
vielleicht - maybe
sich sicher sein - to be sure
irgendwann - at some point
sich einigen - to make an agreement
zu etw. übergehen - to go over to sth.
entweder … oder  - either ... or 
man muss sagen - it has to be said
früher  - previously 
freiwillig - voluntary
studieren - to go to college
witzig - funny
der Sportlehrer - P.E. teacher
jdn. kennen - to know sb.
eigentlich - actually
blöd - stupid
so lange - such a long time
der Mitschüler - classmate
der Klassenclown - class clown
für etw. sorgen - to ensure sth.
ärgern - to annoy
sich melden - to raise one's hand
mutig - brave
extra - on purpose
überrascht sein - to be surprised
trotzdem - nevertheless
die Respektsperson - person commanding respect
komisch - funny
etw. wahrnehmen - to perceive sth.
etw. anbieten - to make an offer
schwierig - difficult
richtig und falsch - right and wrong
das Gefühl - feeling
gesellschaftlich - social
die Schicht - level of society 
zweitgrößte - second largest
klassisch - classic
die Volkspartei - People's Party
die Arbeiterpartei - workers' party
das Verständnis - comprehension
der Genosse - comrade
der Bundeskanzler - chancellor
vermitteln - to communicate
das ungeschriebene Gesetz - unwritten law
von etw. abhängen - to depend on sth.
die Faustregel (ugs.) - rule of thumb (colloq.)
derjenige - the one
etw. anbieten - to offer sth.
in der Regel - in general
in der Realität - in real life
der Anzug - suit
die Lederjacke - leather jacket
auf Augenhöhe - at eye-level
locker - relaxed
es kommt darauf an - it depends
der Zusammenhang - context
das Alter - age
der Kellner - waiter
lockere Atmosphäre - laid-back atmosphere
bedient werden - to be served
der Kundenkontakt - customer contact
etw. bestellen - to order sth.
andersherum - the other way around
sich als Regel setzen - to set as a rule
zu etw. aufgefordert werden - to be asked to do sth.
passieren - to happen
so alt wie ich - as old as I am
formell - formally
komisch - weird
jdn. anreden - to address sb.
das Spannende - the exciting part
Lateinamerika - Latin America
unterschiedlich - different
je nachdem - depending on
die Eltern - parents
etw. ausdrücken - to express sth.
höflich - polite
jdn. treffen - to meet sb.
etw. aufbauen - to build sth. up
quasi - basically
unhöflich - rude
unangebracht - inappropriate
Mitte dreißig - mid-thirties
Anfang vierzig - in one's early forties
die Einschätzung - estimation
spontan - spontaneously
in meinem Alter - at my age
eine Frage stellen - to ask a question
etw. ablehnen - to refuse sth.
mit etw. zu tun haben - to have to do with sth.
offensichtlich - obviously
völlig normal - perfectly normal
umgekehrt - the other way around
die Beamtenbeleidigung - insulting a public official
die Autoritätsfigur - authority figure
über rot fahren - to run a red light
die Beleidigung - insult
rechtlich gesehen - legally speaking
faszinierend - fascinating
da dran hängen - to be connected with
der Polizistenduzer (ugs.) - sb. fearless and cool (colloq.) 
der Spruch - slogan
der Normalfall - normally
sich einig sein - to agree
der Vorname - first name
der Nachname - last name
die Ausnahme - exception
berichten - to report
die Tafel - blackboard
der Begriff - term
die Kassiererin - cashier
Süddeutschland - Southern Germany
verbreitet - spread
absurd - ridiculous
gang und gäbe (ugs.) - common practice (colloq.)
untereinander - amongst each other
die Kasse - cash desk
die Durchsage - announcement
bekannt - well-known
der Mitarbeiter - coworker
das Kuddelmuddel (ugs.) - mess (colloq.)
die Schulzeit - schooldays
sich durchsetzen - to be successful with sth.
etw. benutzen - to use sth.
jdn. nennen - to call sb.
die Mischung - mix
gegenseitig - mutual
etw. einnehmen - to take sth. up
die Hochzeit - wedding
verschmelzen - to melt together
manche Leute - some people
ultra-witzig (ugs.) - ultra funny (colloq.)
etw. kreieren - to create sth.
einmalig - unique
etw. vorlesen - to read sth. out loud
eine Petition starten - to start a petition
ein Gesetz ändern - to change a law
möglich sein - to be possible
der akademische Titel - academic title
empfehlen - to recommend
das Bauchgefühl - instinct
das Amt - office
der Fremde - stranger
zufällig - randomly
der Freund - friend
sympathisch - sympathetic
böse auslegen - to be misinterpreted
früher - previously
der Einzelhandel - retail sector
der Kunde - client
ältere Menschen - elderly people
deswegen - therefore
der Zwang - pressure
spießig - pedantic
sich etw. ergaunern (ugs.) - to scrounge sth. (colloq.)
angebracht sein - to be appropriate
der Rahmen - framework
der Steuerberater - tax consultant
der Verein - association
sich austauschen - to exchange ideas
miteinander - together
die Quintessenz - essence of the matter
unangenehmen - awkward
respektvoll - respectful
schlecht - bad
jdm. etw. übel nehmen - to blame sb. for sth.
etw. lösen - to solve sth.
die Ebene - level
etw. abschaffen - to eliminate sth.
die Formalität - formality
die Höflichkeit - politeness
wandeln - change
die Firma - company
der Wandel - transition
die Pressekonferenz - press conference
der Ministerpräsident - Prime Minister
die Auskunft - information
auseinander gehen - to come apart
unbedingt - necessarily
Mach's gut! - Bye bye!
sich verabschieden - to say goodbye
philosophisch - philosophical
die Weisheit - wisdom
etw. in sich tragen - to carry sth. inside oneself
die Äußerung - statement
etw. versprühen - to spray sth.
der Großvater - grandfather
der Enkel - grandson
bespaßen - to make fun with
kurzzeitig - temporarily
die Stütze - support
seelisch - emotional
die Gesundheit - health
der Rechner - computer
unbeeindruckt - unimpressed
das Weltgeschehen - world events
einen kühlen Kopf bewahren - to keep cool
Zuflucht suchen - to seek refuge
für etw. geschaffen sein - to be made for sth.
das Denken - thinking
die Antike - antiquity
glücklich - happy
mit etw. fertig werden - to manage sth.
Epikureismus - Epicureanism
etw. genießen - to enjoy sth.
die stoische Schule - Stoicism 
erwiesenermaßen - as has been proved
so einfach ist es nicht - it's not that easy
die Etappe - stage
leiden - to suffer
lieben - to love
von ganzem Herzen - with all my heart
der gesunde Menschenverstand - common sense
aufgebaut sein - to be organized
nach etw. suchen - to search for sth.
der mittlere Weg - middle way
ernst - serious
der Sinn des Lebens - meaning of life
verkehrt - wrong
anfänglich - at the beginning
der lange Weg - long way
tief - deep
der Hund - dog
der Zustand - state
stoisch - stoic
sich Gedanken machen - to think about
die Integrität - integrity
die Tapferkeit - courage
das Handeln - action
diszipliniert - disciplined
ausgeprägt - distinctive
nachlässig - careless
sich gehen lassen - to let oneself go
schlendrianisch (ugs.) - to be sloppy (colloq.)
etw. erwähnen - to mention sth.
berühmt - famous
der Brief - letter
etw. gestehen - to confess sth.
zufällig - by chance
das Buch - book
die Betrachtung - observation
die Beharrlichkeit - insistence
der Lebensstil - lifestyle
teuer - expensive
nützlich - useful
im Grunde - basically
gelassen - relaxed
der Tod - death
die Sehnsucht  - longing 
hervorragend - excellent
klug - sold out
handeln - normally
einen Laden leerkaufen - to buy fast
jdm. etw. überlassen - advice
jeden Tag - to skip sth.
ausverkauft - death
normalerweise - influence
zuschlagen - dangerous
der Rat - longing 
etw. überspringen - excellent
smart - to be sloppy (colloq.)
to act - 
to empty a shop - 
to leave sth. to sb. - 
every day - 
die Freiheit - freedom
voll sein - to be full up
völlig okay - totally okay
sich unterhalten - to talk
etw. füllen - to fill sth.
unterbrechen - to interrupt
die Mongolei - Mongolia
die Fähigkeit - ability
die Eigenschaft - characteristic
als Erstes - first
die Definitionsfrage - matter of definition
realistisch - realistic
der Traum - dream
fliegen - to fly
seit ich ein Kind bin - ever since I was a child 
im wörtlichen Sinne - literally
der Grund - reason
die Ausbildung - training
wünschen - to wish
überall - everywhere
auffallen - to attract attention
Zeit haben - to have time
arbeiten - to work
schlafen - to sleep
auf etw. angewiesen sein - to depend on sth.
körperlich - physically
schlafbedürftig - in need of sleep
Spaß machen - to be fun
verrückt - crazy
die Ruhezeit - rest period
ausgeglichen - balanced
ausgeruht - relaxed
anspruchsvoll - demanding
etw. formulieren - to verbalize sth.
mit etw. umgehen - to handle sth.
Probleme bewältigen - to solve problems
der Gedanke - thought
konfrontiert werden - to be confronted
im Gegensatz zu - contrary to
der Wunsch - wish
an etw. arbeiten - to work on sth.
empathisch - empathic
die Frau - woman
aufwachsen - to grow up
im Kopf vorgehen - to happen in one's head
der Mann - man
ausgeprägt sein - to be distinctive
etw. steigern - to increase sth.
auffallen - to notice
die Weltreise - world trip
auf etw. bedacht sein - to be concerned about sth.
ruhig - calm
erklären - to explain
sich um etw. bemühen - to try hard for sth.
übertreffen - to surpass
schlau - smart
der Fortschritt - progress
bewundernswert - admirable
unrealistisch - unrealistic
die Bedenken - concerns
orientiert - orientated
egal - not important
besonders - special
das Thema - subject
die Maske - mask
in echt - in real life
der Ort - place
reisen - to travel
gefangen sein - to be trapped
schlimm - terrible
mit Sicherheit - for certain
entschleunigen - to slow down
der Alltag - everyday life
gesundheitlich - health
stören - to bother
Schnipp! (ugs.) - Snap! (colloq.)
akzeptiert - accepted
plötzlich - suddenly
springen - to jump
merken - to notice
auf Toilette gehen - to go to the bathroom
das Abendessen - dinner
lustig - funny
hoffentlich - hopefully