MAZ ab! - Start recording!
albern - goofy
gleichzeitig - at the same time
verschlafen sein - to be sleepy
bekannt von - known from
jmd. beehren - to honor sb.
die Lieblingsepisode - favorite episode
deswegen - this is why
zum zweiten Mal - for the second time
der Gast - guest
nichts dagegen haben - to be okay with it
jmd. austauschen - to replace sb.
das Gefühl - feeling
auf gar keinen Fall - absolutely not
die Umfrage - survey
erstaunlicherweise - surprisingly enough
die Meisten - most
etw. falsch beantworten - to answer sth. wrong
die Trickfrage - trick question
mit Absicht - purposely
auftauchen - to show up
einen trinken (ugs.) - to have a drink (colloq.)
plätschern (ugs.) - to go on (colloq.)
feuchtfröhlich (ugs.) - merrily (colloq.)
auf einmal - all of a sudden
der Fußboden - floor
die Kopfschmerzen - headache
die Stimmung - mood
überkochen (ugs.) - to boil over (colloq.)
anschließend - then
das Saufgelage (ugs.) - booze-up (colloq.)
sich für etw. entschieden - to choose sth.
die Zeit - time
froh sein - to be glad
weder noch - neither nor
jmd. abfangen - to catch sb.
ursprünglich - originally
unterrichten - to teach
seit Längerem - for some time now
danken - to thank
sondern auch - but also
leben - to live
spitze - great
das Kompliment - compliment
spannend - exciting
jmd. zuhören - to listen to sb.
das Ausland - abroad
die Überleitung - transition
etw. einführen - to introduce sth.
bereit sein - to be prepared
der Anschlag - attack
etw. besprechen - to discuss sth.
aktuell - current
rechtsradikal - right-wing extremist
motiviert sein - to be motivated
jmd. umbringen - to kill sb.
der Migrationshintergrund - migration background
sich aufhalten - to stay
heute Morgen - this morning
schauen - to look
etw. darüber lesen - to read about it
offensichtlich - obviously
geistig gestört  - mentally disturbed
die Wahnvorstellung - delusion
beziehungsweise - respectively
eine Rolle spielen - to matter
mehrfach - multiple
die Mitverantwortung - co-responsibility
der Bevölkerung - populatio
die Waffe - weapon
der Verwirrte  - deranged
das Krasse (ugs.) - extreme (colloq.)
leicht - easy
die Gedanken - thoughts
anfangen - to start
anders aussehen - to look differently
nicht zu uns gehören - to not belong to us
das Denkmuster - thinking pattern
sich mit jmd. auseinandersetzen - to deal with sb.
sich miteinander unterhalten - to talk to each other
sich gegenseitig zuhören - to listen to each other
miteinander - together
die Plattform - platform
der Themenvorschlag - proposed topic
sich etw. überlegen - to consider sth.
der Vorschlag - suggestion
etw. ablehnen - to reject sth.
spontan - spontaneously
auf die Idee kommen - to come up with the idea
rumgehen - to walk around
worüber - about what
ich würde sagen - I would say
sprechen - to speak
ein Thema aussuchen - to pick a topic
das Zeitlimit - time limit
na gut - alright, then
etw. verwenden - to use sth.
es geht los - here we go
etw. vorstellen - to present sth.
ablaufen - to expire
witzig - funny
etw. vorlesen - to read sth. out
etw. aufschreiben - to write sth. down
auf etw. hinweisen - to point sth. out
jmd. gerecht werden - to do justice to sb.
jmd. treffen - to meet sb.
etw. vermischen - to mix sth. up
eben - just
beantworten - to answer
die Frage - question
freischaffend - freelance
die Schauspielerin - actress
die Schriftstellerin - writer
die Künstlerin - artist
das Theaterstück - play
das Hörbuch - audio book
das Themensegment - topic segment
einschenken - to pour
Angst haben - to be scared
Krach machen - to make noise
sich benehmen - to behave oneself
sondern - but
allgemein - general
detailliert - detailed
die Politik - politics
das Reisen - traveling
etw. formulieren - to phrase sth.
der Pfeffer - pepper
kacke (ugs.) - crap (colloq.)
etw. rechtfertigen - to justify sth.
erzählen - to tell
kaputt - damaged
vorher - previously
Bescheid wissen - to know
im Endeffekt - in the end
unbedingt - necessarily
die Überraschung - surprise
eine ganze Menge - a good deal
weltweit - worldwide
der Weltkrieg - World War
die Messlatte - bar
sich etw. ausdenken - to make sth. up
die Wahl - election
merkwürdig - strange
stören - to bother
etw. mögen - to like sth.
keiner - nobody
meiner Meinung nach - from my point of view
gehören - to belong to
der Rassist - racist
der Misogynist - misogynist
der Mafiosi - mafioso
die Bereicherung - enrichment
der Narzisst - narcissist
in keinster Weise - in no way
zu etw. Gutem beitragen - to contribute to sth. good
sich über etw. unterhalten - to discuss sth.
überhaupt nicht - not at all
zufällig - randomly
mit etw. umgehen - to deal with sth.
zumindest - at least
draußen - outside
etw. Besonderes - sth. special
philosophieren - to philosophize
sich selbst betrachten - to look at oneself
der Spiegel - mirror
sich erkennen - to recognize oneself
etw. wissen - to know sth.
sich entwickeln - to evolve
gemeinsam - together
etw. anschauen - to take a look at sth.
entstehen - to come into being
die Herkunft - origin
das Lebewesen - living being
der Unterschied - difference
sich weiterentwickeln - to develop
das Gehirn - brain
grundsätzlich - basically
die Pflanze - plant
das Nervensystem - nervous system
Schmerz verspüren  - to feel pain 
unwahr - not true
bluten - to bleed
was es ausmacht - what it takes
rumlaufen - to run around
die Wissenschaft - science
knallhart - very tough
probieren - to try
die Autobahn - highway
sich unterhalten - to talk
manchmal - sometimes
im Großen und Ganzen - generally speaking
etw. verstopfen - to block sth. up
überfahren - to run over
der Verkehrstote - road fatality
die Maßnahme - measure
der Fußgänger - pedestrian
der Fahrradfahrer - cyclist
lachen - to laugh
schreien - to shout
sich etw. vorstellen - to imagine sth.
komfortabel  - convenient 
der Nahverkehr - local public transport
das Transportnetz - transport network
mittlerweile - meanwhile
sich bewegen - to move around
auf dem Land - in the countryside
völlig - completely
das Transportmittel - means of transport
persönlich - personally
etw. nachvollziehen können - to be able to understand sth.
das Statussymbol - status symbol
die Faszination - fascination
andererseits - on the other hand
etw. bewerten - to rate sth.
die Gegenbewegung - countermovement
das Mädel (ugs.) - the girl (colloq.)
der Klimaschutz - climate protection
die lokale Küche - local cuisine
sozusagen - so to speak
kochen - to cook
das Buchweizen - buckwheat
der Kollege - colleague
schwierig zu kriegen - difficult to get
etw. beitragen - to contribute sth.
ehrlich gesagt - to be honest
aufschreiben - to write down
tatsächlich - actually
das Frühstück - breakfast
die Bohnen - beans
die Soße - sauce
etw. kriegen - to get sth.
besagte  - said 
importiert - imported
schade - too bad
herstellen - to produce
wahrscheinlich - probably
teuer - expensive
bezahlen - to pay
irgendwelche - any
das Vierfache - four times as much
die gleichen Sachen - the same things
spekulieren - to speculate
das Containerschiff - container ship
wegnehmen - to take away
die Zutaten - ingredients
das Geschäft - shop
afrikanisch - african
sich überlegen - to consider
nach Bedarf - as needed
etw. abfrühstücken (ugs.) - to get sth. done (colloq.)
die Arbeitssuche - job search
auf etw. achten - to pay attention to sth.
die Ausbildung - education
der Arbeitgeber - employer
nämlich - actually
im Gegensatz zu - in contrast to
der Lebenslauf - curriculum vitae
der Abschluss - degree
wie ist jmd. drauf - what's someone like
das Unternehmen - company
die Arbeitskraft - worker
etw. empfehlen - to recommend sth.
auf gar keinen Fall - definitely
gleichzeitig - simultaneously
ein guter Weg - a good way
das Auslaufmodell - discontinued model
jmd. anstellen - to hire sb.
der Beruf - profession
der Werdegang - career path
zukunftsorientiert - future-oriented
die Arbeitserfahrung - work experience
ein Programm schreiben - to write a program
das Tierrecht - animal rights
leiden - to suffer
denken - to think
typisch - typical
etw. erzählen - to tell sth.
was denkst du über - what do you think about
das Billigfleisch - cheap meat
wo es herkommt - where it comes from
jedes Mal - each time
im Kopf vorgehen - thoughts are going on
Fleisch zerlegen - to cut up meat
das Regal - shelf
körperliches Bedürfnis - physical need
der Vegetarier - vegetarian
die Weltreise - world trip
einerseits - on the one hand
der CO2-Ausstoß - CO2 emission
verringern - to decrease
worum es geht - what it is about
der Meinung sein - to think that
unterscheiden - to differ
komplex - complex
ethisch schwierig - ethically difficult
solches Leid antun - to do such harm
die Massentierhaltung - factory farming
das Wild - game
die Überbevölkerung - overpopulation
die gewisse Verantwortung - certain responsibility
stattfinden - to take place
milliardenfach - billions of times
quälen - to torture
das Wildschwein - wild boar
der Hirsch - deer
die Populationskontrolle - population control
der Jagdschein - hunting license
etw. zubereiten - to prepare sth.
das Gefrierfach - freezer
vertretbar - justifiable
nachgucken (ugs.) - to check (colloq.)
im Vergleich - in comparison
ungefähr - approximately
der höchste Anteil - highest share
was ist dein Tipp - what's your tip
überrascht sein - to be surprised
die Zahl - number
niedrig - low
jeder zehnte - one in ten
gerade jetzt - especially now
der Klimawandel - climate change
gesellschaftlich - socially
sich für etw. entscheiden - to go for sth.
ein gewisser Wandel - some change
der Keller - basement
der Wortschatz - vocabulary
die Beziehung - relationship
der Kosename - pet name
Schatz - sweetheart
der Liebling - darling
Schatzipupsi - sweety little fart
der Hase - bunny
das Bärchen - little bear
mein Herz  - my heart 
die Prinzessin - princess
das Mäuschen - little mouse
die Kröte - toad
du bist mir wichtig - you are important to me
ich liebe dich - I love you
in einer Beziehung sein - to be in a relationship
wenn du es fühlst - if you feel it
ansonsten - otherwise
stärker - more powerful
etw. abschwachen - to tone sth. down
ich hab dich lieb - love you
die Eltern - parents
die Geschwister - siblings
heiraten - to get married
die Bedeutung - meaning
fast genauso - almost the same
auffallen  - to notice
seine Schuhe ausziehen - to take one's shoes off
gekommen um zu bleiben - come to stay
grob gesagt - broadly put
bequem - comfortable
gähnen - to yawn
angepisst sein (ugs.) - to be pissed (colloq.)
das Beispiel - example
der Lebensabend - twilight years
etw. zusammenbauen - to put sth. together
etw. empfinden - to feel sth.
der Weltschmerz - world-weariness
traurig - sad
als etw. erscheinen - to appear as sth.
das Leid - suffering
die Katerstimmung (ugs.) - hangover mood (colloq.)
dementsprechend - correspondingly
der Augenblick - moment
der Blick - look
blicken - to have a look
doppelt - double
der Klang - sound
die Hochzeit - wedding
gefallen - to like
sich etw. reinstopfen (ugs.) - to stuff sth. in one's mouth (colloq.)
das Abendessen - dinner
etw. trinken - to have a drink
fünftägig - five-day
entspannt sein - to be relaxed
der Kater - hangover
saufen (ugs.) - to get drunk (colloq.)
zusammensitzen - to sit together
grillen - to have a barbecue
Neudeutsch - as we now call it
die Brautleute - bride and groom
rumrödeln (ugs.) - to toil away (colloq.)
gestresst sein - to be stressed
etw. übernehmen - to cover sth.
tiefenentspannt - deeply relaxed
die Erfahrung - experience
fressen (ugs.) - eat (colloq.)
der Eindruck - impression
mit sich anfangen wissen - to know what to do with oneself
untereinander - among each other
kosten - to cost
kurzfristig - at short notice
das Bier - beer
sich etw. bestellen - to order sth.
als erstes - first
etw. wissen müssen - to need to know sth.
höflich - politely
der Anfang - in the beginning
etw. korrigieren - to correct sth.
über etw. sprechen - to speak about sth.
häufig - frequently
etw. ausdrücken - to be express sth.
etw. nehmen - to take sth.
furchtbar - horrible
ordentlich - properly
das Empfinden - perception
von etw. getriggert sein - to be triggered by sth.
von wem - by whom
ich hätte gern - I would like to have
etw. bekommen - to get sth.
nochmal - again
am Anfang - at the beginning
ernst - serious
die Politikwissenschaften - political science
sich mit etw. beschäftigen - to deal with sth.
deswegen - therefore
die Feststellung - statement
erstaunlich - astonishing
das Vorurteil - prejudice
überhaupt - anyway
das Atomprogramm  - nuclear programme 
das Bankkonto - bank account
etw. eröffnen - to open sth.
etw. auffallen - to notice sth.
die Feindschaft - animosity
reisen - to travel
das große Ziel - big goal
der Wunsch - wish
von etw. berichten - to report on sth.
die Gastfreundschaft - hospitality
die Machthaber - those in power
schwerfallen - to be difficult
ein ähnliches Bild - a similar picture
dadurch - thereby
schwierig - difficult
die politische Lage - political situation
etw. dagegen tun - to do something about it
eine Sache verfolgen - to pursue a matter
etw. verändern - to change sth.
die Intellektuelle - intellectual
die Bevölkerung - population
etw. sehen - to see sth.
das Leben - life
die Institution - institution
etw. ernst nehmen - to take sth. seriously
auf etw. stolz sein - to be proud of sth.
der Familienbund - family circle
der Zusammenhalt - solidarity
die Entscheidung - decision
die Zustimmung - approval
zuhause wohnen - to live at home
wesentlich - main
auf etw. eingestellt sein - to be attuned to sth.
aufwachsen - to grow up
unabhängig sein - to be independent
jmd. etw. vorschreiben - to tell sb. how to behave
mit jmd. zusammen sein - to be with sb.
beide Seiten - both sides
auf etw. zurückfallen - to fall back on sth.
eine Frage stellen - to ask a question
auf Empfehlung - on recommendation
den Kontakt abbrechen - to break off contact
verpflichtet sein - to be obliged
die Anforderung - demand
die Erwartung - expectation
ein Recht auf etw. haben - to have the right to sth.
die Freiheit - liberty
die Auswirkungen - effects
etw. verwirklichen - to put sth. into effect
der Austausch - exchange
etw. dabei belassen - to leave sth. at that
etw. verschieben - to reschedule sth.
verstehen - to understand
die Wasserpause - water break
quatschen (ugs.) - to chat (colloq.)
aufstehen - to stand up
die Heizung - heating
grenzwertig - borderline
rumkommen (ugs.) - to get around (colloq.)
die gute Laune - good mood 
streng sein - to be strict
etw. einspielen - to play sth.
etw. hinzufügen - to add sth.
etw. folgen - to follow sth.
improvisieren - to improvise
beeindruckend - impressive
einem Skript folgen - to follow a script
vor allem - primarily
die Nachrichtenshow - news show
klingen - to sound
etw. ist vor geschrieben - sth. is pre-written
munter - lively
durch die Gegend (ugs.) - around (colloq.)
die Kopfschmerzen - headaches
die dumme Idee - bad idea
kurzzeitig - briefly
in Versuchung - tempted
verhangen - confusing
die Stimmung kocht über (ugs.) - the mood is exploding (colloq.)
rumrödeln (ugs.) - to to toil away (colloq.)
reinschreiben - to write in sth.
etw. benutzen - to use sth.
die Braut - bride
der Bräutigam - groom
schwer - heavy
hin und her laufen - to walk around
arbeiten - to work
etw. erledigen - to take care of sth.
die Lampe - lamp
die andere Ecke - the other corner
der Drucker - printer
etw. reparieren - to fix sth.
die Glühbirne - light bulb
gehetzt sein - to be rushed
die Richtung - direction
rumschreien (ugs.) - to shout (colloq.)
laufen - run
herumlaufen - to run around
der Zeitdruck - time pressure
der Gastbeitrag - guest contribution
etw. an jmd. richten - to address sth. to sb.
ständig - permanently
etw. kurz halten - to cut sth. short
keine Zeit haben - to have no time
sich aufdrängen - to impose oneself
abschließen - to complete
tief in Gedanken - deep in thoughts
aus heiterem Himmel - out of the blue
von etw. abweichen - to deviate from sth.
unglaublich - incredible
mittlerweile - by now
etw. aufnehmen - to record sth.
übernehmen - to take over
los müssen - to have to leave
etw. erfüllen - to comply with sth.
sich in Rage reden - to talk oneself into a fury
sich echauffieren - to get worked up
sauer sein - to be annoyed
wütend - angry
etw. bedienen - to operate sth.
der Knopf - button
die Abwechslung - variety
schlecht - bad
seit längerer Zeit - for some time now
genießen - to enjoy
die Stimmung - atmosphere
besonders - special
unterschiedlich - different
eine andere Welt - another world
jmd. vom Hocker reißen (ugs.) - to rock sb's boat (colloq.)
die ganze Zeit - all the time
hier sein - to be here
sich freuen - to be happy
die Empfehlung - recommendation
sich weigern - to refuse
etw. einfallen - to think of sth.
der Lieblingschannel - favorite channel
die Leidenschaft - passion
das Wissen - knowledge
etw. verkaufen - to sell sth.
traumhaft - fantastic
etw. finden - to find sth.
die Liegestütze - push-ups
sich etw. sparen - to spare oneself sth.
weggehen von etw. - to move away from sth.
recht haben - to be right
und zwar - in fact
etw. kennen - to know sth.
die Autorin  - writer
junges Publikum - young audience
grob gesagt - roughly speaking
ansprechend - appealing
Deutschland kennenlernen - to get to know Germany
aufpassen - to pay attention
ein großer Fan - a huge fan
seit neuestem - most recently
etw. bestimmtes - sth. specific
ich habe früher - I used to
insbesondere - in particular
die Startseite - homepage
meistgelesen - most read
jeweilige - respective
viele Menschen - a lot of people
etw. ablesen - to gauge sth.
was jmd. beschäftigt - what occupies sb.
der Präsidentschaftskandidat - candidate for the presidency
jmd. erschießen  - to shoot sb. 
am heutigen Tage - on this day
angesagt sein - to be popular
das Land - country
wunderschön - wonderful
zum Abschluss - in the end
etw. vorziehen - to bring sth. forward
etw. abspielen - to play sth. back
mir ist aufgefallen - I noticed
verwenden - to use
der Ursprung - origin
verwandeln - to transform
außerdem - also
der Rechner - computer
die Verliebtheit - being in love
die Stimme - voice
der Radiosprecher - radio host
bestimmen - to determine
der Volksmund - vernacular
am natürlichsten - most natural
die Mehrheit - majority
sich ergeben - to arise
die These - theory
der Busfahrer - bus driver
am naheliegendsten - most obvious
irgendwo - somewhere
die Kommission - commission
sich entscheiden - to be decided
mehrere Artikel - multiple articles
das Schlimmste - the worst
kein Mensch - no person
schwankend - fluctuating
das Gefälle - gradient
zu beobachten sein - to be observable
je weiter desto - the further the more
südlich - south
verbreitet - spread
scheinen - to seem
passen - to fit
klingt richtig - sounds about right
laut etw.  - according to sth. 
der Deutschlerner - German learner
nehmen - to take
der Maßstab - measure
ziehen nach - to move to
zweitgrößte - second largest
etw. ausblenden - to blend sth. out
der Einwohner - inhabitant
reinbringen - to bring in sth.
müde - tired
ausgeschlafen sein - to be rested
antreten - to line up
ein Foto machen - to take a picture
sich verabschieden - to say goodbye
die Zuhörer - audience
vorab - in advance
sich entschuldigen - to apologize
die schlechte Stimmung  - bad mood 
besonders - especially
abgesehen von - aside from
von etw. angekotzt sein (ugs.) - to be pissed off at sth. (colloq.)
ungehalten - indignant
schwächeln (ugs.) - to slack (colloq.)
die Professionalität - professionalism
etw. ausgleichen - to compensate for sth.
einfach - simply
die Ruhe selbst - calmness itself
in der Mitte - in the middle
etw. bezeichnen - to describe sth.
perfekt - perfect
etw. zusammenfassen - to summarize sth.