gleichzeitig - at the same time
einen Podcast aufnehmen - to record a podcast
das Multitasking - multitasking
komisch - weird
verschieden - different
der Ort - place
überrascht sein - to be surprised
gar nicht - not at all
das hört sich so an - it sounds like
die Magie - magic
hassen - to hate
ungewohnt - unusual
auf etw. reagieren - to respond to sth.
der Schlafanzug - pyjamas
ordentlich - properly
die Aufnahme - recording
etw. bewegen - to move sth.
der Hintergrund - background
allerdings - however
der Auftritt - appearance
aufregend - exciting
etw. aufnehmen - to record sth.
berichten - to report
umziehen - to move
geheim - secret
der Bericht - report
auffallen - to be noticed
etw. ansprechen - to bring sth. up
insofern - in this respect
etw. verfolgen - to follow sth.
sich beschweren - to complain
eigentlich - actually
theoretisch - theoretically
einsteigen - to enter
praktisch - practically
die Sitzplatzreservierung - seat reservation
etw. erwähnen - to mention sth.
rennen - to run
einen Tag vorher - the day before
nämlich - namely
zufällig - randomly
der Schaffner - conductor
wirken - to appear 
auf den ersten Blick - at first sight
etw. genießen - to enjoy sth.
erinnern an etw. - to evoke sth.
abheben - to take off
normalerweise - normally
die Strecke - route
der Rückweg - return trip
überschreiten - to cross
langsam - slow
die technische Störung - technical fault
Meilen pro Stunde - miles per hour
die Autobahn - highway
angenehm - pleasant
Freunde finden - to make friends
vorlesen - to read aloud
etwas Besonderes - something special
treffen - to meet
wunderbar - wonderful
lieb - sweet
mit jmd. zusammensitzen - to sit down with sb.
angesprochen werden - to be approached
die hohe Dichte - high density
offensichtlich - obviously
nachdem - after
herzlich - warmly
leidenschaftlich - passionate
lustig - funny
die Prüfung - exam
die Aufgabe erledigen - to get the task done
der Anfang des Jahres - beginning of the year
unterhaltsam - entertaining
nützlich - useful
endlich - finally
das Ausrufezeichen - exclamation mark
der Zaubertrick - magic trick
seinen Augen nicht trauen - to not believe one's eyes
schockiert sein - to be shocked
bestimmt - determined
witzig - funny
das Mitglied - member
aussteigen - to get off
sobald - as soon as
jmd. überraschen - to surprise sb.
dazu gehören - to be included
gerne - gladly
mehrmals - several times
mal kürzer, mal länger - sometimes shorter, sometimes longer
anwesend sein - to be present
stimmt - true
wieder - again
richtig - right
meistens - mostly
sich freuen - to be happy
zur Familie gehören - to be a member of the family
etw. weiterleiten - to pass sth. on
aktuell - current
der Termin - date
der Deutschlehrer - German teacher
beachtenswert - noteworthy
treu - faithful
der Supermarkt - supermarket
die Lieblingsfolge - favorite episode
demnächst - soon
etw. kopieren - to copy sth.
einfach - simply
lauern - to lie in wait
jmd. erschrecken - to scare sb.
die Einkaufstüte - shopping bag
die lustige Folge - funny episode
gucken - to look
der treue Fan - faithful fan
etw. einführen - to introduce sth.
die Wahl - election
der Wunsch - wish
divers - various
zumindest - at least
worüber - about what
bewegt sein von etw. - to be moved by sth.
sogar - even
auf etw. angesprochen werden - to be asked about sth.
sich etw. vorstellen - to imagine sth.
diskutieren - to discuss
wie etw. gesehen wird - how sth. is seen
was angesagt ist - what's going on
spannend - exciting
was wird diskutiert - what's being discussed
versuchen - to try
worum es geht - what it's about
jmd. etw. schulden - to owe sb. sth.
feierlich - solemnly
etw. überreichen - to hand sth. over
annehmen - to accept
wetten - to bet
stattfinden - to take place
überzeugt sein von etw. - to be convinced of sth.
etw. herauszögern - to delay sth.
die Verhandlung - negotiation
das Referendum - referendum
sich entscheiden - to decide
komisch - funny
es tut mir leid um etw. - I'm sorry about sth.
das Vereinigte Königreich - the United Kingdom
etw. richtig kriegen (ugs.) - to get sth. right (colloq.)
austreten - to leave
wehtun - to hurt
mindestens - at least
der Abgeordnete - Member of Parliament
singen - to sing
der Abschied - farewell
überraschend - surprisingly
berührend - touching
an den Händen halten - to hold hands
der Hammer (ugs.) - amazing (colloq.)
überhaupt - actually
schottisch - scottish
bekannt - famous
der englischsprachige Raum - English-speaking region
der Jahreswechsel - turn of the year
ursprünglich - originally
traurig - sad
die Ansage - announcement
kontinentaleuropäisch  - continental european 
der Schock - shock
unfassbar - unbelievable
die Strömung - trend
die Partei - party
etw. verstehen - to understand sth.
das einzig Gute - the only good thing
der Zweite Weltkrieg - Second World War
die Gemeinschaft - community
unmöglich - impossible
untereinander - among each other
Krieg führen - to wage war
die Gefahr - danger
die Nostalgie - nostalgia
selbst gemacht - homemade
überlaufen - to run over
passend - fitting 
die Stimmung - mood
sich mit etw. abfinden - to accept sth.
keinen Bock haben (ugs.) - to not be in the mood (colloq.)
wobei - although
die Übergangsregelung - transitional arrangements
verhandeln - to negotiate
der Binnenmarkt - Single Market
der Übergang - transition
hoffentlich - hopefully
etw. empfehlen - to recommend sth.
regelmäßig - regularly
verbringen - to spend
vorproduzieren - to pre-produce
in der Nähe von etw. - near sth.
dummerweise - unfortunately
rumrennen (ugs.) - to be running around (colloq.)
das Lager - side
repräsentieren - to represent
teilweise - partly
zu Recht - with justification
aus den Löchern kommen (ugs.) - come out of hiding (colloq.)
die Langeweile - boredom
die Wut - anger
abhauen - to leave
sich begegnen - to meet each other
der Vorwurf - accusation
die weitreichende Entscheidung - far-reaching decision
mit etw. umgehen - to handle sth.
sich auf etw. freuen - to look forward to sth.
Wellen schlagen - to make waves
der Einfluss - impact
die Bundespolitik - German politics
der Zuhörer - listener
abschalten - to switch off
das Bundesland - Federal State
der Ministerpräsident - Prime Minister
passieren - to happen
etw. aussprechen - to say sth.
von etw. ausgehen - to assume sth.
wählen - to vote
die Mehrheit - majority
eindeutig - clearly
miteinander - together
das regionale Parlament - regional parliament
bestehen aus - to consist of
die Konstellation - constellation
regieren - to reign
sozusagen - so to speak
schwierig - difficult
wichtig - important
jmd. aufstellen - to nominate sb.
das Spektrum - spectrum
akzeptieren - to accept
der Grundsatz - principle
sich etw. verschrieben fühlen - to feel obliged to do sth.
das Grundgesetz - Basic Law
etw. infrage stellen - to question sth.
deswegen - therefore
sowohl … als auch - both … and
mit jmd. zusammenarbeiten - to work with sb.
legitimieren - to legitimize
sich verhalten - to act
stattdessen - instead
geschlossen - united
somit - therefore
die Macht - power
jmd. zu etw. verhelfen - to help sb. get sth.
dazu führen - to lead to
annehmen  - to accept 
etw. schaffen - to achieve sth.
der Aufschrei - outcry
die Kanzlerin - chancellor
etw. wiederholen - to repeat sth.
in irgendeiner Form - in one way or another
zurücktreten - to resign
mithilfe von etw. - with the aid of sth.
das rechte Spektrum - right spectrum
jmd. verehren - to admire sb.
etw. verorten - to situate sth.
das Grundproblem - fundamental problem
die Grundfrage - basic question
die Gesetzeswahl - enactment of a law
mithelfen - to help
etw. repräsentieren - to represent sth.
der Landesvorsitzende - regional chairman
etw. annehmen - to accept sth.
die Kanzlerkandidatin - candidate for the chancellorship
aussichtsreich - promising
sich von etw. distanzieren - to distance oneself from sth.
antreten - to compete
der Riesenskandal - big scandal
im Endeffekt - effectively
der Abstand - distance
ausländerfeindlich - xenophobic
die Meinung - opinion
etw. zulassen - to allow sth.
leider - unfortunately
sich von etw. abgrenzen - to distance oneself from sth.
das Hauptthema - main subject
öfter - more often
in Zukunft - in the future
gerade - just
beziehungsweise - respectively
mittlerweile - meanwhile
die Frage - question
über etw. sprechen - to speak about sth.
von etw. berichten - to report on sth.
rauchen - to smoke
die Raucherkneipe - smokers' bar
weit weg - far
hinfahren - to go there
behaupten - to claim
Sinn machen - to make sense
drinnen - inside
erstaunlich - astonishing
scheißegal sein (ugs.) - to not give a damn (colloq.)
trotzdem - nevertheless
während - during
warten - to wait
der Jugendliche - teenager
gut gekleidet - well-dressed
seriös aussehend - looking respectable
Sapperlot (ugs.) - goodness gracious (ugs.)
eine Zigarette angestecken - to light a cigarette
dreist - brazen
die Respektlosigkeit - disrespect
leid tun - to be sorry
bei jmd. sein (ugs.) - to understand sb.'s point (colloq.)
insgesamt - in total
die Richtung - direction
schlimm - bad
sich über etw. aufregen - to be upset about sth.
streiten - to argue
das Eigentum - property
die Lunge - lungs
ausrasten - to freak out
aufschreiben - to write down
tatsächlich - actually
womit - with which
sich mit etw. beschäftigen - to occupy oneself with sth.
sich etw. überlegen - to consider sth.
das Bahnfahren - rail travel
die Freizeit - free time
etw. rausfinden - to find out about sth.
etw. ausreizen - to exhaust sth.
die Empfehlung - recommendation
unglaublich - incredible
etw. hat mir geholfen - sth. has helped me
die Weltreise - world trip
wirklich - really
alles wissen über etw. - to know all about sth.
sich auskennen - to know a lot
mehr oder weniger - more or less
etw. auschecken (ugs.) - to check sth. out (colloq.)
verschiedene Klassen - different classes
der Unterschied - difference
der Vorhang - curtain
das Bettzeug - bedding
säuberlich - clean
liebste - favorite
auf jeden Fall - definitely
fast - almost
die Baustelle - construction site
jemand - someone
der Kühlschrank - refrigerator
das Waschbecken - sink
aufwachen - to wake up
die Aussicht - view
die Landschaft - scenery
der Speisewagen - dining car
frühstücken - to have breakfast
Daumen nach oben - thumbs up
planen - to plan
dauern - to take
zwischendurch - meanwhile
ungefähr - approximately
die Transsibirische Eisenbahn - Trans-Siberian Railway
ein kleiner Anfang - a small start
sich klar werden über etw. - to figure sth. out
der Ausflug - trip
der Wahnsinn - crazy
die Vielfalt - diversity
überall - everywhere
etw. bekommen - to get sth.
unterschiedlich - different
sich verändern - to change
ein Haus bauen - to build a house
motiviert sein - to be motivated
mehr zu reisen - to travel more
Sprachen lernen - to learn languages
im Hintergrund - in the background
sich etw. schnappen (ugs.) - to grab sth. (colloq.)
hinweisen auf - to refer to
etw. zaubern - to create sth.
der Nachtisch - dessert
etw. ausprobieren - to give sth. a try
etw. zusammenwerfen (ugs.) - to throw sth. together (colloq.)
schmecken - taste
lecker - delicious
fade - bland
das Gewürz - spice
das Salz - salt
der Pfeffer - pepper
gesund - healthy
stolz - proud
wörtlich - verbatim
experimentieren - to experiment
etw. erschaffen - to create sth.
das Universum - universe
in flüssiger Form - in liquid form
zu sich nehmen - to consume
das Spiegelei - fried egg
abwarten - to wait and see
gefroren  - frozen 
der Eiswürfel - ice cube
etw. verdünnen - to dilute sth.
glänzen - to shine
die Hausaufgabe aufgeben - to give homework
der Begriff - expression
die Geschichte - history
die Zukunft - future
mit Sicherheit - for certain
das Gehirn - brain
ausgerichtet sein auf etw. - to be aligned with sth.
das Jahrtausend - millennium
jemanden finden - to find someone
sich fortpflanzen - to reproduce
gegen etw. anrennen (ugs.) - to run against sth. (colloq.)
die Rückmeldung - feedback
die Welle - wave
lieb - dear
die Fachleute - professionals
dankbar sein für etw. - to be grateful for sth.
möglich - possible
jmd. etw. versprechen - to promise sth. to sb.
publizieren - to publish
etw. finden - to find sth.
dazu gehören - to belong to it
der Zusammenhang - context
die Aussage - statement
die Idee - idea
die Schöpfung - the Creation
merkwürdig - strange
weit verbreitet - widely spread
etw. behaupten - to claim sth.
ähnlich - similar
weit entfernt - far away
der Atheist - atheist
der Schöpfer - the Creator
der Ansatz - approach
etw. hinwerfen (ugs.) - to drop sth. (colloq.)
die Behauptung - claim
scheinen - to appear
etw. berühren - to touch on sth.
christlich - christian
der Religionsunterricht - religious education
diktieren - to dictate
der Widerstand - resistance
andächtig - reverent
an etw. glauben - to believe in sth.
die Kirche - church
sondern - instead
die Menschheit - humanity
die Verzweiflung - desperation
sich entwickeln - to develop
kämpfen - to fight
der Fehler - mistake
überleben - to survive
schmerzhaft - painful
sich überschlagen - to follow in quick succession
im Stande sein - to be able
transzendieren - to transcend
überschreiten - to exceed
katholisch - catholic
sich etw. annähern - to approximate sth.
leisten - to achieve
einverstanden sein - to agree
schlau - smart
das Wissen - knowledge
die Grenze - limit
die Unmöglichkeit - impossibility
seitdem - since then
die Fähigkeit - ability
etw. begreifen - to understand sth.
etw. nennen - to name sth.
vorsichtshalber - as a precaution
vom Thema abkommen - to go off topic 
der Vorschlag - suggestion
übersteigen - to exceed
abschließen - to complete
der Anspruch - demand
zuerst - first
etw. kommentieren - to comment on sth.
etw. übersehen - to overlook sth.
eine Rolle spielen - to matter
die Bewegung - movement
absolut - absolute
der Stillstand - standstill
sich bewegen - to move
existieren - to exist
deshalb - therefore
besagte - said
sich selbst beschreiben - to describe oneself
bekannt - known
hören - to hear
der Kulturkreis - cultural environment
geschätzt werden - to be appreciated
die Seele - soul
das Wesen - being
den Vogel abschießen (ugs.) - to take the cake (colloq.)
dazu lernen - to learn more
im Stande sein - to be able to
etw. verbinden - to connect sth.
etw. besagt, dass - sth. states that
das Wesentliche - essence
der Einblick - insight
etw. untersuchen - to study sth.
die Substanz - substance
ausgedehnt - extended
die Materie - matter
der Geist - mind
der Kopf - head
die Natur - nature
die Realität - reality
in sich tragen - to contain
die riesige Gefahr - huge risk
etw. glauben - to believe sth.
naja - well
entstehen - to come into being
aufgrund - based on
die Kraft - power
sich in etw. hineinversetzen - to empathize with sth.
die Wirklichkeit - reality
etw. verbirgt sich dahinter - to be concealed by sth.
letztendlich - at the end of the day
wie etw. abläuft - how sth. works
etw. hinzufügen - to add sth.
der Lieblingsbegriff - favorite term
helfen - to help
inspirierend - inspiring
vorschlagen - to suggest
etw. betreffen - to relate to sth.
das Prinzip - principle
rechtzeitig - in time
erscheinen - to come out
nach Berlin ziehen - to move to Berlin
die Glaubensfrage - question of faith
durchaus - certainly
esoterisch - esoteric
am Schönsten - most beautiful
ein Bierchen trinken (ugs.) - to have a beer (colloq.)
sämtliche - all
der Kern - core
romantisch - romantic
etw. ausdrücken - to express sth.
farbvoll - colorful
stimmungsvoll - atmospheric
einschlafen - to fall asleep
Hunger haben - to be hungry
der Nachtrag - supplement
der Umgang - handling
die Mischung - mix
der Spielfilm - feature film
ehrlich - honestly
ziemlich - pretty
kostenlos - for free
zeigen - to show
die Anführungsstriche - quotation marks
das Konzentrationslager - concentration camp
vonstattengehen - to take place
die Vergangenheit - past
die Gedenkstätte - memorial
auf Basis von etw. - on the basis of sth.
das Fotoalbum - photo album
etw. angelegen - to create sth.
das Verbrechen - crime
etw. nachempfinden - to reconstruct
empfehlen - to recommend
öffentlich rechtliches Fernsehen - public television
es geht darum - it's about
auffallen - to come to mind
der investigative Journalismus - investigative journalism
zufällig - by chance
weiterleiten - to pass on
der Untertitel - subtitle
die Hörbehinderung - hearing impairment
präzise - accurate
jede Woche - every week
folgendermaßen - as following
am Anfang - at the beginning
die Antwort - answer
geklärt - settled
fallen - to fall
die Schwerkraft - gravity
unbeweisbar - unprovable
komplex - complex
beantworten - to answer
nicht wirklich - not really
etw. empfehlen - to suggest sth.
die Geschichte der Wissenschaft - history of science
im Grunde - fundamentally
früher - earlier
der Bereich - section
etw. auseinandernehmen - to take sth. apart
die Trennung - separation
früher - taste
den Sinn erfassen - to capture the meaning
das Verständnis - understanding
konträr - contrary to
etw. anerkennen - to concede sth.
zutiefst - deeply
etw. verachten - to despise sth.
etw. belächeln - to smile at sth.
lächerlich - ridiculous
beweisen - to prove
begründen - to substantiate
etw. ablehnen - to reject sth.
etw. beweisen - to prove sth.
empirisch - empirical
der Sinn des Ganzen - the meaning of everything
etw. anmerken - to add sth.
die Gelegenheit - occasion
etw. betonen - to emphasize sth.
das Recht haben - to have the right to 
trotz - despite
die Unbildung - lack of education
fehlend - missing
die Ausbildung - education
der Gedanke - thought
die Leidenschaft - passion
quatschen (ugs.) - to talk (colloq.)
die Bewertung - rating
nämlich - because
entdeckt werden - to be discovered
was Phase ist (ugs.) - what's going on (colloq.) 
was abgeht (ugs.) - what's going on (colloq.)
das Jugendwort - youth word
das Mikrofon - microphone
das Mischpult - audio mixer
aufrüsten - to upgrade
ausgestattet sein  - to be equipped 
hinter den kulissen - behind the scenes
die Zwischenfrage - question in between
die Verbesserung - improvement
sich um etw. kümmern - to deal with sth.
irgendwann - sometime
fehlen - to be missing
umdrehen - to turn around
rein greifen (ugs.) - to reach in (colloq.)
nachmittags - in the afternoon
der Szenenapplaus - spontaneous applause