die Servicewüste - the service desert
lustig - amusing
reinholen - to bring in
der Gast - the guest
unterhaltsam - entertaining
das WLAN - the Wi-Fi
hören - to hear
schneiden - to edit
doof - silly
klingen - to sound
sich bei etw. erwischen - to catch oneself doing sth.
mehrfach - repeatedly
die U-Bahn - the subway
das Zeichen - the sign
apropos - speaking of
zu etw. kommen - to get around to sth.
der Klimawandel - the climate change
der Einblick - the insight
das Niveau - the level
die Geschwindigkeit - the speed
die Deutlichkeit - the clarity
großartig - superb
wissen - to know
überraschen - to surprise
der Zuhörer - the listener
ausgezeichnet - excellent
ablesen - to read off
die Aussprache - the pronunciation
erfahren - to learn
bekannt - well-known
seit langem - for a long time
verrückt - insane
das Weltall - outer space
trotzdem - anyway
aus aller Welt - from all over the world
schicken - to send
während - while
beschließen - to decide
hochladen - to upload
etw. freut jmd. - sth. delights sb.
die Tätigkeit - the activity
Vokabelhilfe - vocabulary helper
hilfreich - helpful
benutzen - to use
die Übersetzung - the translation
erwähnen - to mention
zusammen mit - along with
feststellen - to note
etw. vorhaben - to plan to do sth.
unterstützen - der support
in Zukunft - in the future
rausschneiden - to cut out
nicht jugendfrei - not appropriate for minors
vergessen - to forget
das Stichwort - the keyword
sich anfassen - to touch oneself
die Werbung - the advertising
freiwillig - optional
übrig haben - to have available
kostenlos - free
sich überlegen - to consider
unterstützen - to support
recherchieren - to do research
der Begriff - the term
prägen - to coin
der Unternehmensberater - the management consultant
die Wüste - the desert
der Sand - the sand
nachrechnen - to do the math
überraschend - surprising
verstehen - to understand
das Selbstverständnis - the self-image
das Unternehmen - the company
die öffentliche Einrichtung - the public institution
der Ausländer - the foreigner
freundlich - kind
schockiert sein - to be shocked
behandelt werden - to be treated
gang und gäbe - standard practice
der Artikel - the article
die Meinung - the opinion
der Kommentar - the comment
haargenau - precisely
der Laden - the shop
das Geschäft - the store
das Gefühl - the feeling
stören - to bother
die Verkäuferin - the seller
der Berater - the consultant
der Kollege - the co-worker
vermittelt bekommen - to come across
das Schuhgeschäft - the shoe shop
die Größe - the size
verlinken - to link
das Service-Bewusstsein - the service awareness
zu Tränen gerührt sein - to be moved to tears
anständig - decently
bedient werden - to be served
vor kurzem - recently
im Großen und Ganzen - by and large
herzlich - warm-hearted
die Kellnerin - the waitress
unglaublich - unbelievably
interessiert sein - to be interested
die Sprache - the language
das Trinkgeld - the tip
passieren - to happen
geflasht sein (ugs) - to be positively surprised (colloq)
die Gegend - the area
das Ruhrgebiet - the Ruhr area
sich unterhalten - to converse
der Fremde - the stranger
der Klassenunterschied - the class difference
etw. auffallen - to notice sth.
froh sein - to be glad
führen - to run
gründen - to found
der Kunde - the customer
sich anstrengen - to make an effort
lächeln - to smile
sich zu Hause fühlen - to feel at home
wegziehen - to move away
sich gewöhnen - to get used to it
die Einstellung - the attitude
der Bereich - the area
die Menschen - the people
Support leisten - to provide support
nicht besonders - not particularly
bezahlt werden - to be paid
leider - unfortunately
das Ziel - the goal
die Lösung - the solution
im Rahmen von - in the context of
das Ding - the thing
nennen - to name
schmeißen - to throw
erleben - to experience
sozusagen - so to speak
der Typ - the guy
die Verantwortung - the responsibility
helfen - to help
erklären - to explain
der Vorgesetzte - the supervisor
auflegen - to hang up
unhöflich - rude
die Firma - the company
sich erlauben können - to be able to afford
anstellen - to hire
das Gespräch - the conversation
aus Qualitätssicherungszwecken - for quality assurance purposes
mitschneiden - to tape
aufzeichnen - to record
zur Sicherheit - just in case
dürfen - to be allowed
zu verstehen geben - to insinuate
nicht gut laufen - to go badly
lösen - to solve
sich wohlfühlen - to feel comfortable
sich beschweren - to complain
der Mechanismus - the mechanism
dafür sorgen, dass - to ensure that
sich angestrengen - to strive for
etw. mitkriegen - to notice sth.
öffentlich - publicly
ständig - constantly
der Servicegedanke - the service concept
erreichbar sein - to be reachable
der Gedanke - the thought
der König - the king
die Erfahrung - the experience
das Wichtigste - most important
zu weit gehen - to go too far
der Angestellte - the employee
an allerallererster Stelle - in the very very first place
verwandt - related
die Erklärung - the explanation
die Argumentation - the reasoning
der Kellner - the waiter
gering - low
der Stundenlohn - the hourly wage
sich anstrengen - to work hard
verdienen - to deserve
dahingestellt sein - to be left unsettled
die Regeln - the rules
die Nachrichten - the news
das Hauptgeld - the main money
einleuchten - to make sense
dann wiederum - then again
gerade deshalb - precisely for this reason
erwartet werden - to be expected
von etw. abhängen - hinge on sth.
der Mindestlohn - the minimum wage
unterschreiten - to fall short of
der Arbeitgeber - the employer
von etw. ausgehen - to assume sth.
erreichen - to reach
aus unserer Sicht - from our perspective
die Schweinerei (ugs) - the scandal (colloq)
das Gehalt - the salary
zusätzlich - additional
das Getränk - the drink
die Größenordnung - the order of magnitude
die Leute - the people
nicht gut finden - to not like
sich schlecht fühlen - to feel bad
reisen - to travel
in den wenigsten - in very few
das Land - the country
gewöhnt sein - to used to
auffallen - to notice
schon gar nicht - certainly not
älter - older
unterwegs sein - to be out and about
die Eltern - the parents
meistens - in most cases
beschreiben - to describe
die Rechnung - the bill
der Betrag - the amount
bezahlen - to pay
entscheiden - to decide
ausrechnen - to work out
machen Sie … bitte - make it … please
mehrfach - several times
zu blöd - too stupid
unter Druck - under pressure
peinlich - embarrassing
bescheuert - dumb
doof - stupid
geregelt sein - to be organized
die Stadt - the city
unterschiedlich - different
eher - rather
stressig - stressful
zufrieden - pleased
jmd. am Gesicht ansehen - to be able to tell from sb's expression
stehen bleiben - to stay
warten - to wait
nachher - afterwards
das Rückgeld - the change
liegen lassen - to leave
böse gucken - to frown
sauer sein - to be upset
kontaktlos - contactless
das Handy - the cell phone
nicht der Fall sein - to not be the case
das Viertel - the quarter
regelmäßig - regularly
gefangen sein - to be trapped
die Welten - the worlds
das Bargeld - the cash
die Zukunft - the future
ruckzuck (ugs) - in no time (colloq)
dauern - to take
tippen - to tap
der Zweifel - the doubt
in die Hand drücken - to put in sb's hand
die Hosentasche - the pocket
wegnehmen - to steal
die Sorge - the worry
die Zahlung - the payment
(in) bar - (in) cash
die Miete - the rent
einzelne - single
keine Ahnung - no idea
tippen - to guess
die Girokarte - the debit card
die Kreditkarte - the credit card
die Waren - the goods
der Fernseher - the television
der Einzelhandel - retail
verkaufen - to sell
die Jacke - the jacket
das Trivia-Spiel - the trivia game
die Hörverstehensübung - the listening exercise
im Durchschnitt - on average
das Portemonnaie - the wallet
sich lohnen - to be worth it
die Beschwerde-Show - the complaints show
zu etw. verkommen - to degenerate into sth.
sich durchziehen - to pervade
meckern - to grumble
sich echauf­fie­ren - to get upset
der Anlass - the occasion
sich aufregen - to get worked up
das Gesprächsthema - the topic of conversation
die Geschichte - the story
merken - to notice
im Ausland - abroad
verbessern - to make better
der Drang - the urge
sich zurückhalten - to refrain
grenzwertig - borderline
unangenehm - awkwardly
aufeinanderprallen - to clash
mitbekommen - to notice
verbessern - to improve
schief laufen - to go wrong
ausgehen - to run out
so sieht es aus - that's what it looks like
aufschreiben - to write down
der Ausdruck - the expression
zu etw. passen - to go with sth.
die Haltung - the attitude
ums Prinzip gehen - to be a matter of principle
der Vorteil - the advantage
überhaupt - at all
auf etw. hinweisen - to point sth. out
die Sau rauslassen (ugs) - to let it all hang out (colloq)
in Bildern - in pictures
die Redewendung - the idiom
das Mittelalter - the Middle Ages
die Herkunft - the origin
das Kartenspiel - the card game
das Ass - the ace
die Sau - the sow
das Schwein - the pig
weiblich - female
die durchzechte Nacht - the night of drinking
die Tür - the door
der Schweinestall - the pigsty
rauslassen - to let out
sich daneben benehmen - to misbehave
der Schlamm - the mud
sich wälzen - to roll around
streng - strict
die Gesellschaft - society
die Ordnung - the order
ähnlich - similar
im Alltag - in everyday life
sich gehen lassen - to let oneself go
betrunken - drunken
der Karneval - the carnival
Silvester - New Year's Eve
das Feuerwerk - the fireworks
die Rakete - the rocket
der Böller - the firecracker
der Durchschnitt - the average
ausgeben - to spend
an etw. erinnern - to remind of sth.
der Krieg - war
schießen - to shoot
die Angst - the fear
die Flasche - the bottle
Mitternacht - midnight
der Mannschaftswagen - the police van
die Ecke - the corner
der Wall - the fortification wall
das Fahrzeug - the vehicle
die Kampfmontur - the battle outfit
das Fußballspiel - the soccer game
die Großdemonstration - the large-scale protest
die Ausschreitungen - the riots
angreifen - to attack
der Einsatztrupp - the task force
krank - sick
verbringen - to spend
asozial - antisocial
abgesehen davon - apart from that
vom Thema abgleiten - drift off topic
der Richtwert - the recommended level
die Feinstaubpartikel - the fine dust particles
die Luft - the air
gesundheitsgefährdend - hazardous to health
die Jahresmenge - the annual quantity
eine leichte Form - a light form
das Asthma - the asthma
atmen - to breathe
umfassend - comprehensive
nerven - to annoy
sich aufsparen - to save up
zusammenhängen mit - to have to do with
das Leitungswasser - the tap water
der (Wasser-)Hahn - the (water) faucet
das Verständnis - the sympathy
der Großteil - the majority
verdienen - to earn
der Koch - the cook
auf etw. angewiesen sein - to rely on sth.
anbieten - to offer
für etw. zahlen - to pay for sth.
das Sprudelwasser - the sparkling water
verstehen - to comprehend
von mir aus - for all I care
billiger - cheaper
frech - rude
abdrücken (ugs) - to pay (colloq)
verlassen - to leave
essen - to eat
eine Frage des Geldes - a question of money
der Restaurantbetreiber - the restaurant owner
abhängen von - to depend on
vermitteln - to convey
der Umgang - the handling
das Schöne - the nice thing
dran sein - to be on
die Stimmung - the mood
retten - to save
die Stimmung kippt - the mood flips
einschätzen - to gauge
insgesamt - all in all
glücklich - happy
dankbar - thankful
das Fernweh - the wanderlust
das Heimweh - the homesickness
vermissen - to miss
Weihnachten - Christmas
das Gegenteil - the opposite
die Ferne - the distance
das Wörterbuch - the dictionary
stimmt - right
offensichtlich - obviously
geschafft haben - to have managed
spannend - intriguing
seit Jahrzehnten - for decades
die Klimabilanz - the environmental footprint
scheiße - shitty
der Ort - the place
das Heimatgefühl - the feeling of home
die Einsamkeit - loneliness
offensichtlicher - more obvious
um drei Ecken denken (ugs) - to make it really complicated (colloq)
Polen - Poland
die Sicht - the view
empfinden - to perceive
grüßen - to greet
erscheinen - to appear
heimlich - homey
die Bahn - the train
der Kopf - the head
winterlich - winterly
regnen - to rain
daußen - outside
das Kopfkino - inner cinema
sich unterhalten - to talk
sich beschäftigen - to engage with sth.
ernst - serious
jmd. raten - to say to sb.
sich mit etw. beschäftigen - to engage with sth.
pass auf - listen up
tod(es)ernst - dead serious
die Tatsache - the fact
ewig - forever
sterben - to die
im dritten Jahrhundert - in the third century
römische Zeiten - Roman times
das Christentum - Christianity
sich verbreiten - to spread
geschrieben - written
die Ansichten - the views
beschreiben - to depict
Gott - God
offenbaren - to reveal
der Himmel - Heaven
wichtig - important
trinken - to drink
die Eingebung - the inspiration
schlau - astute
arrogant - arrogant
selbstbewusst - self-confident
schlagfertig - witty
zum Lachen bringen - to make sb. laugh
der mittlere Finger / der Mittelfinger - the middle finger
erstaunlich - astonishing
die Mode - the trend
die Fingerbreite - the finger width
umstimmen - to bring sb. around
beweisen - to prove
der kleine Finger - the pinky finger
lächerlich - ridiculous
etw. anstellen - to do sth.
sauer - annoyed
der Mittelfinger - the middle finger
den Stinkefinger zeigen - to flip sb. off
die Schmähgeste - the defamatory gesture
das Phallussymbol - the phallic symbol
die Konnotierung - the connotation
sich beziehen - to reference
onanieren - to masturbate
die Menschenmenge - the crowd
sauer sein - to be angry
der Vorwurf - the accusation
stillen - satisfy
der Bauch - the belly
heutzutage - these days
die Wissenschaft - science
prägen - to shape
die Bevölkerung - the population
der Augenblick - the moment
angefangen mit - starting with
bestehen aus - to consist of
bewirken - to bring about
verzichten - to do without
verstehen - to grasp
die Empfehlung - the recommendation
die Erde - the world
jeweils - each
die Weltreise - the world trip
ankommen - to arrive
um etw. gehen - to be about sth.
die Menge - the quantity
unterwegs - on the way
etw. schaffen - to manage sth.
drin stecken - to be in it
eine Menge  - a lot of 
sich interessieren - to be interested
spezifisch - specific
faktisch - factual
der Fehler - the error
der Überblick - the overview
das Bundesland - the federal state
anschauen - to watch
der Ausschnitt - the section
wirklich - really
jmd. kennen - to know sb.
quasi - practically
gestern Abend - last night
verfügbar - available
etw. fürchten - to be afraid that
anmelden - to log in
probieren - to try
ein paar Wochen - a few weeks
geheimnisvoll - mysterious
die Mauer - the wall
besonders - special
die Stelle - the location
die Stelle - the position
die Straße - the street
umgekehrt - the other way round
strenger - stricter
besuchen - to visit
die Flucht - the escape
verändern - to change
der Mauerbau - the building of the wall
das Fenster - the window
fliehen - to flee
der Grenzpolizist - the border policeman
bewegend - moving
die Gedenkstätte - the memorial
im Vergleich - by comparison
erschießen - to shoot dead
graben - to dig
holen - to get
bauen - to build
entdeckt werden - to be discovered
verstehen - to fathom
das Reisen - the traveling
kennenlernen - to get to know
sich mit etw. beschäftigen - to engage with
anknüpfen - to connect
häufig - frequently
das Reiseland - the travel destination
ans Meer - to the ocean
billig - cheap
das Lied - the song
das Pärchen - the couple
der Refrain - the chorus
die Mitarbeiter - the employees
erwarten - to expect
womöglich - possibly
die Landessprache - the national language
die Flagge - the flag
der Strand - the beach
kritisieren - to criticize
das Kulturwunder - the cultural miracle
das Ausland - abroad
der älteste - the oldest
schreiben - to write
nachgucken - to check
tatsächlich - actually
seit Anfang an - from the beginning
dabei sein - to be on board
beantworten - to answer
so lange - for such a long time
besonders - especially
toll - awesome
das Lob - the praise
sich etw. ausdenken - to invent sth.
aus dem Kontext - from context
erahnen - to surmise
etw. im Kopf haben - to be able to think of sth.
der Vortrag - the lecture
die Bühne - the stage
sich auf etw. freuen - to look forward to sth.
die Bedeutung - the meaning
aufregend - excitingly
spannend - thrilling
die Frage - the question
sich gefreut haben - to have been glad
schneiden - to cut
kriegen - to get
die Beschwerde - the complaint
diejenigen - those
abschalten - to switch off