der Aufruf - the request
der Ordner - the folder
aufregend - exciting
durchgehen - to go through
angefangen bei - starting with
das Schwimmbad - the swimming pool
der Sohn - the son
die Schwimmstunde - the swimming lesson
süß - cute
der Weg - the path
die Hochspannungsleitung - the high voltage line
arbeiten - to work
der Strommast - the power pole
leider - unfortunately
nerven - to hassle
der Chef - the boss
die Tätigkeit - the activity
trocken - dry
wüstenartig - desert-like
das Gebiet - the area
die Leiter - the ladder
der Flughafen - the airport
das Flugzeug - the airplane
der Hintergrund - the background
nachdenklich - contemplative
ordentlich - orderly
der Tagesablauf - the daily routine
der Sportplatz - the sports field
der Wissenschaftler - the scientist
das Aquarium - the aquarium
der Zebrafisch - the zebrafish
untersuchen - to study
zweisprachig - bilingual
erziehen - to raise
verstehen - to comprehend
die Nacht - the night
die Kopfhörer - the headphones
das Spazierengehen - the walk
unseretwegen - because of us
zu Fuß - on foot
Bilderbuch-irisch - Textbook Irish
sich vorstellen - to picture
die Mütze - the cap
der Schal - the scarf
entspannt - relaxed
beeindruckend - impressive
das Fahrrad - the bicycle
der Berg - the mountain
das Tal - the valley
die Serpentinen-Straße - the serpentine road
noch anstrengender - even more strenuous
zustimmen - to agree
zu guter Letzt - last but not least
die WG (Wohngemeinschaft) - the flat share
die Wand - the wall
gerahmt - framed
der Erfolg - the success
der Hinweis - the note
der zentrale Ort - the central place
schicken - to send
neu aktiviert - newly activated
die Kommentarfunktion - the comment function
am Anfang - at the beginning
immer der gleiche - always the same
besprechen - to discuss
das Mitglied - the member
hinterlassen - to leave
sich anmelden - to register
natürlich - of course
vor allem - most of all
grün - green
lesen - to read
an etw. gewöhnt sein - to be used to sth.
beantworten - to reply
bekommen - to receive
der Vorteil - the advantage
der Nachteil - the disadvantage
auf der einen Seite - on the one hand
komisch - strange
aufnehmen - to record
veröffentlichen - to publish
persönlich - personally
etw. fehlt jmd. - sb. is missing sth.
persönlicher - more personal
die Meinung - the opinion
der Hass-Kommentar - the hate comment
wie etw. angenommen wird - the response to sth.
gespannt sein - to be curious
ehrlich gesagt - to be honest
an etw. liegen - to be due to sth.
das Handy - the cell phone
der Aufwand - the effort
erwarten - to anticipate
gutheißen - to endorse
der Hochspannungsmast - the high-voltage pole
absteigen - to get off
die Sicherheit - the safety
die Mauer - the (Berlin) Wall
fallen - to fall
auf dem Weg hierhin - on the way here
Ostdeutschland - East Germany
zur Erinnerung - in remembrance
gedenken - to commemorate
der Gesprächspartner - the interviewee
miterleben - to witness
der Onkel - the uncle
die Zeit - the time
die Mauer - the wall
der Mauerfall - the fall of the Berlin Wall
befragen - to interview
die Erfahrung - the experience
geschichtlich - historical
geteilt - divided
etw. bewusst sein - to be aware of sth.
der Krieg - the war
beendet sein - to be over
die Siegermacht - the victorious power
die Besatzungszone - the occupation zone
einnehmen - to seize
die Westmächte - the Western powers
die Schwierigkeit - the difficulty
zusätzlich - in addition
die Hauptstadt - the capital
wichtig - important
der Zugang - the access
aufgeteilt - segmented
schwierig - difficult
durchsetzen - to impose
die Insel - the island
die Grundschule - the primary school
die (gesamtdeutsche) Grenze - the (all-German) border
die Bundesrepublik (Deutschland) - the Federal Republic (of Germany)
die DDR (Deutsche Demokratische Republik) - the GDR (German Democratic Republic)
die Möglichkeit - the possibility
dazu führen, dass - to lead to
etw. mitbekommen - to notice sth.
wirtschaftlich - economical
der Aufbau - the construction
flüchten - to flee
der Mauerbau - the building of the Wall
ausbluten - to drain
verlassen - to leave
jährlich - annually
im Laufe der Trennung - in the course of the division
der Stadtteil - the city district
weiterreisen - to travel on
der Pass - the passport
wohnen - to reside
beantragen - to apply
das Asyl - the asylum
die Bundesrepublik Deutschland - The Federal Republic of Germany
der Personalausweis - the identity card
die Rechte - the rights
der Zug - the train
der Grenzpolizist - the border policeman
die Republikflucht - the flight from the republic
angeklagt werden - to be charged
das Flugzeug - the plane
der Ausländer - the foreigner
betrachten - to regard
die Besatzung - the occupation
etw. schaffen - to accomplish sth.
fliehen - to flee
umgekehrt - conversely
das Ausland - abroad
sich verändern - to change
die Nacht- und Nebelaktion - the cloak-and-dagger operation
der Maurer - the bricklayer
heranschaffen - to bring over
der Geheimdienst - the intelligence services
anfangen - to begin
die Befestigung - the fortification
am Werke sein - to be at work
der Grenzsoldat - the border soldier
bewaffnet - armed
bewachen - to guard
die Beziehung - the relationship
sich umstellen - to adjust
das Tragische - the tragedy
die Stadt - the city
geteilt sein - to be divided
besuchen - to visit
die Katastrophe - the catastrophe
die Stimmung - the mood
die Teilung - the division
nicht weit entfernt sein - to be not far away
der Anblick - the sight
mitbekommen - to notice
zu dem Zeitpunkt - at that time
riesen(groß) - large
das Waldgebiet - the forest
der See - the lake
das Gefängnis - the prison
empfinden - to perceive
der Passierschein - the permit
der Mindestumtausch - the minimum exchange
ausgeben - to spend
die Buchhandlung - the bookshop
die Zeitung - the newspaper
die Zeitschrift - the magazine
die Ostblockstaaten - the Eastern bloc countries
nutzen - to make use of
die Museumsinsel - the Berlin Museum Island
langweilig - boring
das Geschäft - the shop
ausgestattet - resourced
im Hinterkopf - in the back of one's mind
das Reaktorunglück - the nuclear accident
mit etw. umgehen - to deal with sth.
berichten - to report
der Spielplatz - the playground
trinken - to drink
der Pilz - the mushroom
der Wald - the forest
sammeln - to gather
das Stillschweigen - the secrecy
sich Sorgen machen - to worry
die freie Presse - the free press
was etw. ausmacht - the difference sth. makes
Abschied nehmen - to say goodbye
der Tagesbesuch - the day visit
der Tränenpalast - the Palace of Tears
stattfinden - to take place
die Abschiedstränen - the parting tears
etw. pflegen - to maintain sth.
mitbekommen - to witness
erwähnen - to mention
die Stimmen - the voices
das Gefühl - the feeling
hoch spannend - extremely fascinating
die Unruhen - the unrests
der Jahrestag - the anniversary
feiern - to celebrate
einladen - to invite
die Vorgeschichte - the previous events
im Vorfeld - beforehand
die Nachrichten - the news
das Begrüßungsgeld - the welcome money
bis heute - to this day
umgekehrt - the other way around
der Zeitpunkt - the point in time
trennen - to divide
das damalige Leben - life back then
die Sichtweise - the view
die Arroganz - the arrogance
etw. erwähnen - to mention sth.
befreiend - liberating
etw. verkürzt darstellen - to condense sth.
die Freiheit - freedom
der Bereich - the area
die Hoffnung - the expectations
enttäuschen - to fail
nachdenken - to ponder
teilweise - in part
verlieren - to lose
ein Stück - a bit of
die Heimat - the home
schnell - swift
die Veränderung - the change
plötzlich - all of a sudden
zufällig - by accident
wiedervereint - reunited
die Befreiung - the liberation
etw. wahrnehmen - to perceive sth.
der Heimatverlust - the loss of home
der Teil - the part
mittlerweile - by now
etw. beleuchten - to illuminate sth.
etw. außer Acht lassen - to disregard sth.
das Jubiläum - the anniversary
einseitig - one-sided
der Lebensbereich - the area of life
das Krankenhaus - the hospital
das Pflegeheim - the nursing home
die Behörde - the authority
sich ändern - to change
mit etw. klarkommen - to cope with sth.
die Arbeitslosigkeit - the unemployment
der Grundsatz - the principle
konkurrenzfähig - competitive
etw. übernehmen - to adopt sth.
das Ampelmännchen - the traffic light man
traurig - sad
der Stolz - the pride
rechtens sein - to be right
der Begriff - the term
der Unrechtsstaat - state without rule of law
anwenden - to apply
nichtsdestotrotz - nonetheless
von heute auf morgen - from one day to the next
(um)ziehen - to move
abenteuerlustig - adventurous
schwer fallen - to be difficult
in Betracht kommen - to come into question
umziehen - to move house
das, was etw. ausmacht - the essence of sth.
jmd. bewusst sein - to be aware of
die Entscheidung - the decision
stell dir mal vor - just imagine
aufwachsen - to grow up
die Anpassungsbereitschaft - the willingness to adapt
leiden - to suffer
die Kirche - the church
oppositionell - oppositional
der Lebensstandard - the standard of living
führend - leading
Spaß haben - to have fun
etw. anerkennen - to acknowledge sth.
ein gutes Leben führen - to lead a good life
die Einschränkung - the restriction
der Urlaub - to vacation
nach der Wende - after the fall of communism
das Schlusswort - the closing remarks
die Seite - the side
beleuchten - to shed light on
herausstellen - to point out
schwarz und weiß - black and white
der Gute - the good guy
die Bösen - the bad guys
siegen - to triumph
die Geschichte - the history
auswählen - to choose
die Sau - the sow
die Sau rauslassen (ugs.) - to go wild (colloq.)
der Ausdruck - the expression
unter aller Sau (ugs.) - really bad (colloq.)
das Schwein - the pig
bedeuten - to signify
schlecht - bad
dreckig - filthy
das Kinderzimmer - the nursery
aufräumen - to tidy up
bildlich - figuratively
das Unternehmen - the company
auflegen - to hang up
die Herkunft - the origin
unter aller Kanone (ugs.) - really bad (colloq.)
heutzutage - nowadays
seltener - rarer
unterhalb - below
der Maßstab - the standard
der Schüler - the student
scherzhaft - humorously
die Kanone - the cannon
die Waffe - the weapon
sich entwickeln - to evolve
sich ableiten - to be derived
verstehen - to understand
zum Scherz - as a joke
Schwein haben (ugs.) - to be lucky (colloq.)
die Redewendung - the idiom
Glück haben - to be lucky
kein Mensch - nobody
der Mast - the mast
runterfallen - fall off
weich - soft
der Baum - the tree
nichts passiert - unharmed
Schwein gehabt (ugs.) - got lucky (colloq.)
das Sprichwort - the proverb
der Wettbewerb - the competition
der Trostpreis - the consolation prize
meckern - to grumble
etw. ausweiten - to expand sth.
unbedingt - absolutely
recherchieren - to do research
das Tier - the animal
prägen - to shape
sau- (ugs.) - really (colloq.)
die Stärkung - the reinforcement
jmd. auffallen - to notice
das Schimpfwort - the swearword
alle durch haben - be through with all
das nervt - that sucks
die Lieblings-Kategorie - the favorite category
die Umfrage - the survey
die Mitglieder - the members
glücklich - happy
vorlesen - to read aloud
anmelden - to sign up
jmd. unterstützen - to support sb.
die Besten - the best
nicht alles schaffen - be unable to do everything
zur Auswahl stellen - to put to selection
teilnehmen - to participate
mögen - to like
toll - awesome
Sinn machen - to make sense
genauso viele - just as many
die Abstimmung - the vote
jmd. freut etw. - sb. is happy about sth.
schieß los - shoot
der Alltag - everyday life
die Beschwerde - the complaint
die Polin - the Polish woman
unfreundlich - rude
zum Glück - fortunately
sich anders überlegen - to change one's mind
die Werbung - to publicity
sich beschweren - to complain
verbessern - to improve
klar werden - to realize
die Ausstellung - the exhibition
auffallen - to notice
von einigen - of some
die Freude - the joy
die Wiedervereinigung - the reunification
im Vordergrund stehen - to be in the focus
etw. beleuchten - to shed light on sth.
verloren gehen - to be lost
die Nachteile - the disadvantages
jmd. widerfahren - to happen to sb.
dankbar - thankful
verstehen - to grasp
was das heißt - what that means
genug - enough
die schönen Seiten - the upsides
aufschreiben - to write down
nachdenken - to think about
auf jeden Fall - in any case
gemeinsam - joint
in Kategorien denken - to think in categories
ehemalig - former
seine Gründe haben - to have it's reasons
der Zyklus - the cycle
sich bestärken - reinforce itself
etw. schuldig sein - to be guilty of sth.
sich äußern - to express oneself
die Gedanken - the thoughts
über etw. nachdenken - to contemplate sth.
das Bundesland - the federal state
in den Sinn kommen - to come to mind
sprachlich - linguistically
die Sicht - the view
der Fehler - the fault
unbewusst - unconsciously
auf etw. achten - to pay attention to sth.
die Geschichte - the story
mit etw. verbinden - to associate with sth.
der Wechsel - the change
der Systemwechsel - the system change
gespalten - divided
die Gesellschaft - the society
abhauen - to abscond
sich wohl fühlen - to feel comfortable
sich zugehörig fühlen - to feel belonging
etw. aufgegeben - to give sth. up
etw. ablehnen - to reject sth.
die Einstellung - the attitude
sicher - safe
sich fühlen - to feel
die Spaltung - the division
die Leute - the people
gezwungen werden - to be forced
negativ aufstoßen - to upset
wählen - to vote
rechter - more right
schrecklich - terrible
aus meiner politischen Sicht - from my political point of view
zu Recht - justifiably
bemängeln - to find fault with
erzeugen - to create
die Gegenreaktion - the backlash
bestärken - to reinforce
sich abwenden - to turn away
das Dorf - the village
zurückgelassen werden - to be left
sich auf etw. einigen - to agree on sth.
aufpassen - to be wary
sich kurz fassen - to be brief
sozusagen - so to speak
ausgiebig - profusely
beklagen - to lament
die Fahrrad-Infrastruktur - the bicycle infrastructure
der Fortschritt - the progress
die Pressemitteilung - the press release
fortschrittlich - progressive
der Bezirk - the district
kopieren - to copy
der Straßenblock - the city block
zusammenfassen - to combine
dürfen - to be allowed
der Rettungswagen - the ambulance
das Lieferfahrzeug - the delivery vehicle
der Anwohner - the resident
der Fußgänger - the pedestrian
verbannen - to banish
sich etw. vorstellen - to visualize sth.
helfen - to be of help
die Meldung - the news
zu verlauten haben - to be announcing
es wird etw. getan - sth. is being done
abschauen - to copy
die Empfehlung - the recommendation
suchen - to search
die Moderatorin - the hostess
bekannt - well-known
der Künstler - the artist
die Wende - the fall of communism
der Durchbruch - the breakthrough
zu tun haben mit - to have to do with
spannend - fascinating
anhand von - on the basis of
nachvollziehen - to trace
abspielen - to play back
sich wünschen - to wish
jmd. fehlen - to miss
übersetzt - translated
die Buchempfehlung - the book recommendation
etw. gestehen - to confess to sth.
der Roman - the novel
meistens - normally
fortgeschritten - advanced
die Verfilmung - the film version
erst - first
wenn überhaupt - if at all
auf etw. hinweisen - point sth. out
die Serie - the TV series
das Sprachenlernen - language learning
das Kinderbuch - the children's book
der Erwachsene - the adult
der Lieblings-Kinderbuchautor - the favorite children's book author
der allererste - the very first
sympathisch - likable
der Typ - the character
das Wohnzimmer - the living room
wie das ist - what it's like
zu etw. passen - go with sth.
etw. thematisieren - to address sth.
grauer Beton - gray concrete
das Lied - the song
verantwortlich sein - to be responsible
das Stück - the piece
sich erinnern - to remember
der Plattenbau - the pre-fabricated building
die Jugendlichen - the youth
die Heimat - the home country
die Erinnerung - the memory
verschwinden - to vanish
schlecht machen - to badmouth
die Existenzängste - the existential fears
sich mit etw. beschäftigen - to deal with sth.
zum Nachdenken bringen - to make sb. think
wahrnehmen - to perceive
der Zuhörer - the listener
die Statistiken - the statistics
die Audio-Nachricht - the audio message
zuerst - first
die Verbposition - the verb position
der Nebensatz - the subordinate clause
der Fehler - the error
der Kasus - the case
akzeptabel - acceptable
komisch - odd
klingen - to sound
zumindest - at least
die Erlaubnis - the permission
die Umgangssprache - the colloquial language
nachdenken - to contemplate
der Muttersprachler - the native speaker
ob - if
sich auf etw. verlassen - to rely on sth.
etw. nicht so genau nehmen - to take sth. lightly
gerade - especially
die Verbpositionen - the verb positions
die Satzstellung - the word order
die Flexibilität - the flexibility
falsch - wrong
die Stelle - the position
benutzen - to use
die Fälle - the cases
das Beispiel - the example
unterstreichen - to emphasize
versuchen - to attempt
bestimmte Fehler - specific errors
etw. extra machen - to do sth. on purpose
das Gespräch - the conversation
in Ordnung - okay
beim Sprechen - while speaking
hinzufügen - to add
der Sprachenlehrer - the language teacher
aller Zeiten - of all time
gravierend - grave
das Ziel - the goal
übers Netz - over the net
schlagen - to hit
die Kurve - the curve
gerade eben so - only just so
solange - as long as
das schlechte Gewissen - the guilty conscience
abschalten - to switch off
freiwillig - voluntary