herzlich willkommen - a warm welcome
zurück - back
begrüßen - to greet
vorbereiten - to prepare
klingen - to sound
die Außenpolitik - foreign policy
der Scherz - the joke
gucken - to see
reagieren - to react
gut klappen - to work out well
schon lange - for a long time
faszinieren - to intrigue
das Ding - the thing
es gibt etw. nicht mehr - sth. no longer exists
der Alltag - everyday life
benutzen - to use
gestern - yesterday
die Zukunft - the future
aufpassen - to be careful
tot sein - to be dead
ausgebildet sein - to be trained
die Verantwortung - the responsibility
irrsinnig - mind-boggling
der Führerschein - the driving licence
der Stahl - the steel
unterm Arsch (ugs.) - underneath one's butt (colloq.)
passieren - to happen
sterben - to die
im Großen und Ganzen - by and large
schief gehen - to go wrong
dauern - to take
etw. übernehmen - to take over sth.
miteinander - with each other
der Sicherheitsaspekt - the safety aspect
der Stau - to traffic jam
gleichzeitig - at the same time
losfahren - to start driving
die Kettenreaktion - the chain reaction
selbstfahrend - self-driving
von jetzt auf gleich - at once
hoffen - to hope
der Individualverkehr - individual transportation
ablösen - to supersede
seltsam - strange
steuern - to operate
besitzen - to own
der Schritt - the step
zur Verfügung haben - to have at one's disposal
der Passagier - the passenger
wertvoll - valuable
die Großstadt - the big city
in Zukunft - in the future
rumstehen - to stand around
ausprobieren - to try out
im Prinzip - basically
mitnehmen - to pick up
der Umweg - the detour
einsammeln - to collect
vorbeikommen - to stop by
seitdem - ever since
frustriert - frustrated
spontan - spontaneously
nichts anderes übrig bleiben - to have no choice
im ersten Schritt - at first
gibt es die - will they still exist
ausarten - to get out of hand
die Verständnisfrage - the comprehension question
die Batterie - the battery
zum Wegschmeißen - disposable
die Schallplatte - the vinyl record
irgendwo - somewhere
im Gebrauch - in use
das Fernsehen - the television
gedruckt - printed
das Handy - the cell phone
innerhalb - within
die Brille - the glasses
die Tastatur - the keyboard
das Eingabemittel - the input device
der Gedanke - the thought
aufzuschreiben - to write down
das Schnitzel - the cutlet
die Übergröße - the supersize
pervers - perverse
keine Ahnung - no clue
das Fax - the fax machine
das Bargeld - cash
der Strohhalm - the straw
die Plastikverpackung - the plastic packaging
allgemein - in general
begrenzt - limited
der Drucker - the printer
nerven - to annoy
funktionieren - to function
wie etw. soll - how sth. is supposed to
der Heizpilz - the patio heater
nennst - to name
die Lebzeit - the lifetime
vorspielen - to play
raten - to guess
die Atomkraft - nuclear power
aus modischer Sicht - from a fashion point of view
überflüssig - unnecessary
der Verbrennungsmotor - the combustion engine
der Kellner - the waiter
die Rennstrecke - the racetrack
die Massentierhaltung - factory farming
ernsthaft - seriously
verschwinden - to disappear
die Menschheit - humanity
erfahren - to experience
altersbedingt - age-related
die Sterblichkeit - the mortality
überwinden - to overcome
die Zelle - the cell
verlängern - to prolong
die Armut - the poverty
das Bevölkerungswachstum - the population growth
der Nationalstaat - the nation state
als Konzept - as a concept
das Geld - the money
das Bargeld - the cash
generell - in general
der Krieg - the war
am sichersten - surest
leider - unfortunately
zufällig durchmischt - randomly mixed
die Antwort - the answer
widersprüchlich - contradictory
zum Teil - in part
das Gegenteil - the opposite
überzeugen - to persuade
etw. feststellen - to establish sth.
vorhersagen - to predict
unterschätzen - to underestimate
überschätzen - to overestimate
der Wandel - the transformation
sich verändern - to change
krass - starkly
zurückschauen - to look back
der Riesen-Sprung - the giant leap
einschätzen - to assess
der Zeitraum - the time period
unmöglich - impossible
vorhersehen - to predict
das Gesellschaftliche - the social
die Quelle - the source
die Vorstellungskraft - the imagination
die Ausstellung - the exhibition
malen - to paint
raussuchen - to pick
der Abschnitt - the section
berechnen - to determine
der Forscher - the researcher
eintreffen - to become reality
die Vorhersage - the prediction
eintreten - to occur
feststellen - to observe
richtig liegen - to be correct
bestehend - existing
weiterdenken - to think further
auf etw. hinweisen - to point sth. out
berührungslos - contactless
das Gerät - the device
über etw. verfügen - have sth. at one's disposal
die Forschung - the research
gewaltig - tremendous
der Computertomograf - the computer tomograph
zusammenschrumpfen - to shrink
die Alltagsmedizin - the everyday medicine
voraussagen - to predict
sich beeinflussen - to influence each other
der Wissenschaftler - the scientist
erfinden - to invent
das Wohnen - the housing
ähnlich - similar
sich ausweiten - to widen
die Fläche - the surface
die Höhe - the height
die Tiefe - the depth
bauen - to build
sich fortbewegen - to move
das Gebäude - the building
das Transportwesen - the area of transportation
die Erfindung - the invention
ein einzelner Mensch - a single person
fliegen - to fly
funktionieren - to work
etw. lösen - to solve sth.
das Naturgesetz - the natural law
die Luft - the air
reiben - to rub
der Krach - the noise
lautlos - silent
das Wasser - the water
die Erde - the earth
das Wohnen - housing
das Ballungsgebiet - the urban agglomeration
das Tageslicht - the daylight
die Tageslichtlampe - the daylight lamp
freiwillig - voluntarily
reich - rich
arm und reich - rich and poor
sich sicher sein - to be sure
die Entwicklung - the development
das Jahrhundert - the century
sich umkehren - to be reversed
immer stärker - ever stronger
die Gesellschaft - society
das Zwischenmittel - the intermediary
verteilen - to distribute
missverstanden werden - to be misunderstood
beschrieben - described
das Geld - money
zusammenschweißen - to bond together
sich auf etw. einlassen - to engage in sth.
der Handel - trade
etwas Schlechtes - something bad
die Ungerechtigkeit - the injustice
nicht haltbar sein - to be untenable
die Geschichte - history
das Tauschmittel - the medium of exchange
das Goldstück - the gold piece
die Münze - the coin
das Ersatz-Geld - the substitute money
der Wert - the value
die Währung - the currency
abschaffen - to abolish
die Zerstörung - the destruction
überwinden - to transcend
unwahrscheinlich - unlikely
die Lösung - the solution
das Konstrukt - the construct
die Schulden - the debts
Sinn machen - to make sense
nachdenken - to think about
ansprechen - to mention
die Grenze - the border
an Wert verlieren - to depreciate in value
entstehen - to emerge
sich wehren - to resist
sich ändern - to change
die Frage - the question
französisch - French
der Künstler - the artist
anlässlich - on the occasion of
die Weltausstellung - the World Exhibition
in Auftrag geben - to commission
der Absatz - the paragraph
das Werk - the artwork
sich vorstellen - to imagine
durchgucken - to look through
das Fluggerät - the aircraft
die Gondel - the gondola
die Flügel - the wings
die Vorstellung - the idea
etw. umsetzen - to make sth. a reality
spannender - more exciting
wahr werden - to come true
die Schnur - the cord
die Wohnung - the apartment
sauber - clean
schrubben - to scrub
der Staubsauger - the vacuum cleaner
das Lieblingsbild - the favorite picture
das Mittel - the means
vorhanden - available
aus heutiger Sicht - from today's point of view
dumm aussehend - silly-looking
der Besen - the broom
der Boden - the floor
tragen - to carry
ziehen - to pull
die Rollschuhe - the roller skates
Anlauf nehmen - to take a run-up
sich bewegen - to move
selbstfahrend - self-propelled
heutzutage - nowadays
der Roller - the scooter
der Akku - the rechargeable battery
der Schuh - the shoe
anschieben - to nudge
der Einfluss - the influence
bekannt - well-known
selbstschließend - self-closing
etw. konzipieren - to devise sth.
zubinden - to tie
ökonomisch - economically
aufwändig - cumbersome
nichts bringen - to be useless
sich durchsetzen - to catch on
die Einschränkung - the limitation
der Fall - the case
entwickeln - to develop
die Übergangstechnologie - the transitional technology
die Größe - the size
das Ding ist - the thing is
sich an etw. orientieren - to be guided by sth.
das Flugzeug - the airplane
die Kommunikationstechnologie - the communication technology
erahnen - to anticipate
ermöglichen - to enable
sich beschäftigen - to look into
verlinken - to link to
aufrufen - to open
der Denker - the thinker
von etw. ausgehen - to assume sth.
der Punkt - the point (in time)
anhalten - to persist
übertreffen - to surpass
in null Komma nichts (ugs.) - in no time (colloq.)
entstehen - to result
zusammengenommen - collectively
der Zustand - the situation
erschaffen - to create
die Entscheidung - the decision
etw. leisten - to accomplish sth.
nicht lange dauern - to not take long
Stichwort (ugs.) - speaking of (colloq.)
etw. durchdenken - to think sth. through
steuerbar - controllable
böse - evil
die Voraussage - the prediction
die künstliche Intelligenz - the artificial intelligence
bestimmte Aufgaben - certain tasks
die Bilderkennung - the image recognition
erkennen - to recognize
der Zusammenhang - the context
der Sinn - the meaning
beweisen - to prove
das Stoppschild - the stop sign
das selbstfahrende Auto - the self-driving car
erkennen - to discern
falsch laufen - to go wrong
in der Lage sein - to be able to
zuverlässig - reliable
überschätzen - overestimate
das Lebewesen - the living being
die Aufgabe - the task
der Ameisenhaufen - the ant-hill
das Grundstück - the property
trotzdem - anyway
plattmachen - to crush
der Stift - the pen
herstellen - to produce
langsam - slow
im Weg stehen - to stand in the way
töten - to kill
die Spracherkennung - the speech recognition
halbwegs - to some extent
deutlich - distinctly
nachkorrigieren - to correct
allerdings - however
die Abkürzung - the abbreviation
gemeint sein - to be meant
das Verständnis - the comprehension
aufschreiben - to write down
die Hoffnung - the hope
verstehen - to understand
der Zeitpunkt - the moment
die Bedeutung - the meaning
merken - to notice
zum Abschluss - to conclude
die Aufmerksamkeit - the attention
eintreffen - to come true
frisiert werden - to get a haircut
der Friseurmeister - the barber master
bedienen - operate
anstellen - to turn on
die Waschmaschine - the washing machine
die Kabine - the cabin
der Kran - the crane
der Knopf - the button
die Baustelle - the construction site
der Lastwagen - the truck
die Zementmaschine - the cement machine
übernehmen - to undertake
der Bauarbeiter - the construction worker
der Bauingenieur - the civil engineer
die Bauleitung - the site management
involviert - involved
das Feingefühl - the finesse
der Finger - the finger
die Hand - the hand
feinfühlig - nimble
vorprogrammiert - preprogrammed
die Fabrik - the factory
die allerwenigsten - the very fewest
sich trauen - to dare
der Kopf - the head
die Schere - the scissors
weiterführend - continuing
quasi - practically
der Lückenfüller - the gap filler
sozusagen - so to speak
gewissermaßen - as it were
so gut wie - as good as
das Leckerste - the tastiest
quasi - quasi
fast - almost
ungefähr - approximately
insbesondere - in particular
nerven - bug
abgewöhnen - break with
jmd. auf etw. hinweisen - point sth. out to someone
das Gefühl - the feeling
etw. einfließen lassen - to incorporate sth.
der Mitschüler - the classmate
sich an etw. erinnern - to remember sth.
abgespeichert - filed
das Füllwort - the filler
erklären - to explain
die Stelle - the position
der Satz - the sentence
nervig sein - to be annoying
der Fußgänger - the pedestrian
der Radweg - the cycle path
nachsichtig - forgiving
der Fahrradweg - the bicycle path
an etw. liegen - to be due to sth.
gekennzeichnet - marked
klar sein - to be obvious
der Gehweg - the sidewalk
stehen - to stand
der Fahrradfahrer - the cyclist
in erster Linie - primarily
das Transportmittel - the means of transport
deswegen - as a result
bremsen - to brake
etw. merken - to notice sth.
zwischen - between
der Fußweg - the footpath
spät dran sein - to be late
unverständlich - baffling
sich aufregen - to get upset
ankommen - to arrive
etw. checken (ugs.) - to get sth. (colloq.)
klingeln - to ring
unsympathisch - off-putting
ständig - constantly
die Fahrradspur - the bicycle lane
an jeder Ecke - at every turn
auf sich aufmerksam machen - to draw attention to oneself
die Hupe - the horn
das tierische Produkt - the animal product
der Vegetarier - the vegetarian
etw. entdecken - to discover sth.
der Milchersatz - the milk substitute
die Hafermilch - the oat milk
der Bericht - the report
vergleichen - to compare
gut abschneiden - to compare well
schmecken - to taste
aufschäumen - to foam up
der ökologische Fußabdruck - the ecological footprint
die Herstellung - the production
die Kuhmilch - the cow milk
umsteigen - to switch
begeistert sein - to be enthusiastic
die Werbung - the advertising
glücklich machen - to make happy
von etw. wegkommen - to move away from sth.
die Lebensqualität - the quality of life
erwähnen - to mention
anfangen - to start
die Milchprodukte - the dairy products
(aus)probieren - to (try) out
meiner Meinung nach - in my opinion
der Nierenbaum - the cashew tree
nachdenken - to wonder
die Cashewnuss - the cashew nut
die Empfehlung - the recommendation
ausnahmsweise - as an exception
entdecken - to discover
gut aufbereitet - well-presented
der Graph - the graph
die Statistik - the statistic
auf etw. basieren - to be based on sth.
wissenschaftlich - scientific
spannend - fascinating
verbringen - to spend
erschreckend - horrifying
sich entwickeln - to evolve
wählen - to pick
die Richtung - the direction
mit offenen Karten - (to play) with one's cards on the table
die Karte - the map
klassischerweise - usually
die Weltbevölkerung - the world population
die Ernährung - the nutrition
der Ärmelkanal - the English Channel
erklären - to illustrate
das Land - the country
die Stimme - the voice
untertitelt sein - to have captions
mit etw. arbeiten können - to be good enough
die Kartografie - the cartography
folgen - to follow
darstellen - to present
aussuchen - to pick
zu etw. passen - to go with sth.
rausbringen - to put out
der Herbst - autumn
die Zweideutigkeit - the ambiguity
der Ausdruck - the expression
die Aussage - the statement
etw. in Zweifel ziehen - to question sth.
hundertprozentig - completely
sich festlegen - to commit
der Begriff - the term
der Refrain - the chorus
eigentlich - actually
zwischendurch - in between
genannt - mentioned
der Sinn - the purpose
perfekt passen - to work out perfectly
dazu gehören - to belong to it
vergessen - to forget
komisch - strange
der Eindruck - the impression
versuchen - to attempt
der Fehler - the mistake
grundsätzlich - in general
etw. zu schätzen wissen - to appreciate sth.
freundlich - kind
geduldig - patient
lügen - to lie
wechseln - to switch
mehrere Gründe haben - to have several reasons
hilfsbereit - helpful
die Effizienz - the efficiency
ausprobieren - to try
hartnäckig - persevering
mit etw. rechnen - to expect sth.
sich nicht unterkriegen lassen - to stay the course
beim nächsten Mal - next time
bestellen - to order
schwer verständlich - difficult to understand
etw. wertschätzen - to appreciate sth.
die Geduld - the patience
fehlen - to be lacking
außergewöhnlich - extraordinary
der Einwanderer - the immigrant
ungewöhnlich - unusual
die Erfahrung - the experience
auswandern - to emigrate
der Versuch - the attempt
gefeiert werden - to be celebrated
stolz - proud
vorkommen - to occur
sich aussuchen können - to have a choice
eine dankbare Sprache - a rewarding language
dankbar - thankful
der Verwandtschaftsgrad - the degree of kinship
die Tante - the aunt
der Onkel - the uncle
ausflippen - to flip out
vor Freude - out of joy
faszinierend - intriguing
begeistern - to exhilarate
etw. regeln - to handle sth.
sich mit etw. auskennen - to know about sth.
sich schlecht fühlen - to feel bad
sich anpassen - to adapt
das Herangehen - the approach
Hauptsache - what matters
zu Besuch sein - to visit
die Schweiz - Switzerland
überrascht sein - to be astonished
das Frühstück - the breakfast
der Tisch - the table
schwer - difficult
die Nachbarschaft - the neighbourhood
nicht unbedingt - not necessarily
den Kopf schütteln - to shake one's head
sich eine Meinung bilden - to form an opinion
auf den ersten Blick - at first glance
bedenklich - alarming
das Gebiet - the area
eine Frage stellen - to ask a question
beantworten - to respond
sich unterhalten - to chat